Polling Station.1,DR. KAKOLIGHOSHDASTIDAR,MRINAL KANTI DEBNATH,SUKUMAR BALA,SUBRATA DuÂ,HARIPADA BISWAS,OLI MAHAMMAD MALLICK,TUSHAR GHOSH,DIPANKAR BAIDYA,DEBASISH BISWAS,BAM CHAKRABORTY,SAURAV BASU,MRINAL KANTIBHATTACHARJEE,Unnamed: 14,Votes (Test Votes),Unnamed: 16,Total Votes,Unnamed: 18,Unnamed: 19
1,698,66,10,14,176,2,0,3,3,0,2,3,977,0,3,980,0,
2,499,539,2,4,8,1,0,2,2,3,3,17,1080,0,17,1097,0,
3,584,15,10,75,87,1,0,0,0,0,5,2,779,0,10,789,0,
4,416,194,9,20,66,3,0,0,1,1,2,5,717,0,6,723,0,
5,462,508,5,23,91,1,0,0,0,1,0,2,1093,0,9,1102,0,
6,316,488,1,7,25,0,0,0,2,0,1,9,849,0,4,853,0,
7,673,27,6,83,103,0,0,1,1,1,5,1,901,0,12,913,0,
8,453,43,3,6,54,0,0,0,1,0,3,3,566,0,5,571,0,
9,399,14,2,7,91,0,0,0,1,1,1,0,516,0,2,518,0,
10,472,604,2,1,12,0,0,0,1,0,4,10,1106,0,13,1119,0,
11,370,347,1,5,47,2,1,1,1,4,7,6,792,0,8,800,0,
12,390,82,2,14,80,1,0,0,0,1,2,0,572,0,3,575,0,
13,599,17,8,19,114,0,0,0,6,3,3,0,769,0,5,774,0,
14,440,28,10,11,74,1,3,3,0,2,1,1,574,0,3,577,0,
15,350,101,7,17,89,0,1,2,2,3,7,2,581,0,7,588,0,
16,432,31,10,5,98,1,1,1,0,1,0,0,580,0,6,586,0,
17,724,52,13,33,126,1,1,1,1,1,1,2,956,0,4,960,0,
18,347,232,4,6,14,1,2,1,0,1,1,7,616,0,7,623,0,
19,274,684,7,2,5,2,1,2,1,0,4,12,994,0,15,1009,0,
20,606,165,8,52,119,1,2,1,4,5,5,4,972,0,5,977,0,
21,214,204,1,4,13,1,0,1,1,2,2,3,446,0,4,450,0,
22,607,15,12,145,108,2,0,1,3,0,4,2,899,0,10,909,0,
23,603,7,12,53,74,1,0,3,0,3,1,1,758,0,4,762,0,
24,248,437,5,11,25,0,0,2,0,2,1,5,736,0,7,743,0,
25,272,313,6,6,12,0,1,1,0,5,4,3,623,0,10,633,0,
26,409,468,9,12,13,1,1,0,2,5,4,5,929,0,15,944,0,
27,358,655,2,11,46,2,0,1,2,3,1,6,1087,0,7,1094,0,
28,154,432,3,59,8,1,17,0,1,0,0,2,677,0,7,684,0,
29,134,301,5,27,7,0,4,1,1,1,0,5,486,0,8,494,0,
30,330,524,4,6,9,1,0,2,0,1,6,8,891,0,7,898,0,
31,378,382,3,8,12,0,0,0,1,2,2,9,797,0,8,805,0,
32,681,51,8,32,108,2,1,0,2,1,3,2,891,0,5,896,0,
33,295,399,3,1,9,0,2,0,1,2,2,0,714,0,4,718,0,
34,229,447,1,2,3,1,1,0,1,3,4,3,695,0,8,703,0,
35,239,512,0,8,12,0,0,1,2,2,2,6,784,0,6,790,0,
36,232,520,4,4,8,0,2,0,0,3,4,6,783,0,8,791,0,
37,307,689,9,13,26,3,4,2,5,2,4,7,1071,0,10,1081,0,
38,344,326,9,9,45,0,1,1,5,7,7,6,760,0,14,774,0,
39,242,254,7,26,55,2,0,1,1,3,3,5,599,0,3,602,0,
40,662,7,14,24,100,2,0,0,1,0,2,0,812,0,5,817,0,
41,268,259,4,4,5,1,1,1,0,1,4,4,552,0,5,557,0,
42,343,305,1,5,15,0,1,1,0,2,2,5,680,0,7,687,0,
43,663,104,11,56,143,0,0,1,1,1,4,0,984,0,4,988,0,
44,306,270,5,10,42,0,2,0,2,3,3,7,650,0,9,659,0,
45,141,478,4,1,15,0,0,0,0,0,3,5,647,0,6,653,0,
46,375,546,9,9,31,1,0,3,1,6,5,24,1010,0,19,1029,0,
47,319,59,6,12,55,0,0,1,0,0,3,0,455,0,3,458,0,
48,459,6,10,19,142,2,0,1,3,3,1,2,648,0,13,661,0,
49,257,314,3,4,9,1,1,0,0,1,3,3,596,0,5,601,0,
50,230,361,5,3,16,0,0,0,0,1,2,4,622,0,5,627,0,
51,245,390,2,2,17,0,1,0,1,0,2,7,667,0,0,667,0,
52,482,52,9,103,132,2,2,0,3,3,1,2,791,0,5,796,0,
53,516,30,9,31,83,0,0,2,0,2,0,0,673,0,8,681,0,
54,307,266,6,13,64,1,0,2,0,1,5,6,671,0,8,679,0,
55,145,561,4,3,41,1,2,0,4,4,2,7,774,0,10,784,0,
56,415,62,7,13,164,0,0,0,3,0,2,0,666,0,5,671,0,
57,364,41,2,49,41,0,8,0,2,1,0,4,512,0,2,514,0,
58,347,564,5,7,22,0,0,0,1,0,1,2,949,0,10,959,0,
59,673,74,12,33,101,0,3,0,2,3,7,6,914,0,12,926,0,
60,413,253,7,52,34,0,2,1,1,5,3,2,773,0,11,784,0,
61,515,118,7,17,41,0,0,0,0,2,0,1,701,0,6,707,0,
62,417,20,7,70,101,1,1,0,0,0,1,1,619,0,10,629,0,
63,330,96,7,38,70,1,6,2,1,3,1,0,555,0,9,564,0,
64,131,692,9,7,23,2,0,1,1,2,5,5,878,0,3,881,0,
65,240,576,12,9,31,0,2,0,0,2,2,6,880,0,5,885,0,
66,459,211,3,8,7,0,0,0,1,2,1,3,695,0,6,701,0,
67,186,432,65,1,3,0,1,0,1,1,2,2,694,0,8,702,0,
68,238,376,6,12,9,0,0,0,0,0,5,4,650,0,11,661,0,
69,120,504,40,2,10,0,1,1,0,1,0,1,680,0,7,687,0,
70,130,750,27,6,15,0,1,1,2,0,1,4,937,0,6,943,0,
71,384,412,7,18,25,1,1,1,1,1,1,0,852,0,9,861,0,
72,143,638,8,4,25,1,1,0,0,2,5,2,829,0,7,836,0,
73,119,204,0,2,7,0,0,1,0,1,1,3,338,0,1,339,0,
74,349,607,2,0,2,0,0,0,2,1,5,3,971,0,6,977,0,
75,155,495,5,2,8,1,3,0,0,0,0,1,670,0,2,672,0,
76,87,430,14,0,3,0,0,2,0,1,1,0,538,0,3,541,0,
77,248,354,5,6,4,0,0,0,0,0,4,1,622,0,5,627,0,
78,227,578,7,6,43,0,0,0,1,1,2,5,870,0,8,878,0,
79,242,612,20,9,11,0,1,0,1,4,9,10,919,0,11,930,0,
80,462,125,6,40,11,0,0,1,0,1,2,2,650,0,14,664,0,
81,174,442,5,8,0,0,0,0,0,0,1,1,631,0,6,637,0,
82,173,422,3,1,5,0,0,1,1,0,2,5,613,0,6,619,0,
83,226,410,6,10,8,0,0,1,1,1,1,1,665,0,2,667,0,
84,346,430,9,9,13,0,0,1,0,1,0,1,810,0,9,819,0,
85,287,646,5,10,20,0,1,1,3,6,3,9,991,0,10,1001,0,
86,251,497,7,7,18,3,7,0,1,1,1,8,801,0,7,808,0,
87,267,415,7,14,9,0,1,0,0,1,0,1,715,0,3,718,0,
88,298,162,2,1,6,0,0,0,0,0,3,1,473,0,5,478,0,
89,224,309,10,7,4,0,0,0,2,2,1,1,560,0,4,564,0,
90,289,554,11,8,18,0,0,0,0,1,4,5,890,0,4,894,0,
91,505,17,1,39,7,0,1,0,0,2,3,1,576,0,8,584,0,
92,368,297,2,2,9,0,0,0,1,0,3,7,689,0,7,696,0,
93,490,301,4,41,15,0,0,0,1,2,1,3,858,0,7,865,0,
94,669,171,5,106,39,0,0,1,2,2,4,3,1002,0,10,1012,0,
95,258,578,9,3,7,0,1,0,1,1,3,2,863,0,8,871,0,
96,205,639,7,1,35,1,0,2,4,2,13,7,916,0,17,933,0,
97,719,219,4,23,29,0,2,2,0,1,5,0,1004,0,10,1014,0,
98,455,306,7,14,20,2,2,1,3,2,6,2,820,0,7,827,0,
99,514,326,6,19,11,0,0,0,3,3,1,3,886,0,9,895,0,
100,313,630,3,8,16,1,1,1,2,2,4,6,987,0,8,995,0,
101,286,600,2,6,22,0,1,2,1,3,4,4,931,0,6,937,0,
102,207,511,9,14,55,1,1,1,1,3,4,0,807,0,4,811,0,
103,214,435,6,2,5,0,1,0,3,3,5,5,679,0,11,690,0,
104,283,320,1,1,3,0,1,0,4,1,2,3,619,0,6,625,0,
105,332,534,4,14,39,1,0,0,0,6,6,6,942,0,14,956,0,
106,224,463,9,1,10,0,2,0,1,2,4,6,722,0,4,726,0,
107,156,374,5,3,5,0,0,0,0,0,1,3,547,0,2,549,0,
108,233,245,1,12,22,0,2,0,0,0,2,0,517,0,3,520,0,
109,290,429,4,10,12,0,3,0,0,2,4,4,758,0,8,766,0,
110,369,263,9,10,23,0,2,3,2,2,4,8,695,0,12,707,0,
111,226,428,2,5,22,1,1,0,1,1,2,1,690,0,6,696,0,
112,169,399,7,2,11,1,0,1,1,0,3,2,596,0,3,599,0,
113,331,677,5,5,32,2,2,0,0,0,0,3,1057,0,10,1067,0,
114,244,488,3,29,6,2,0,0,0,1,2,4,779,0,6,785,0,
115,205,534,8,9,2,2,0,0,1,0,1,3,765,0,3,768,0,
116,286,577,3,3,27,0,0,2,1,3,6,4,912,0,6,918,0,
117,254,470,8,3,18,0,2,0,0,0,1,5,761,0,2,763,0,
118,301,704,2,2,9,2,2,0,0,2,2,5,1031,0,10,1041,0,
119,231,421,1,3,3,0,1,1,0,0,3,14,678,0,11,689,0,
120,438,640,6,11,5,1,2,0,3,2,8,7,1123,0,16,1139,0,
121,126,501,3,3,12,1,1,0,1,1,0,8,657,0,2,659,0,
122,236,272,2,4,11,0,1,0,1,0,2,2,531,0,5,536,0,
123,421,122,2,6,21,0,19,0,0,0,3,1,595,0,7,602,0,
124,445,174,4,9,47,0,3,2,1,0,2,2,689,0,8,697,0,
125,231,492,6,1,14,1,1,0,0,0,5,7,758,0,9,767,0,
126,292,273,5,8,37,1,1,1,1,3,4,5,631,0,9,640,0,
127,239,479,6,15,28,1,1,0,5,1,2,10,787,0,11,798,0,
128,230,545,3,11,33,1,2,0,0,2,5,3,835,0,5,840,0,
129,270,535,3,9,52,0,2,0,2,1,3,3,880,0,9,889,0,
130,201,468,2,11,17,0,0,1,3,3,4,2,712,0,8,720,0,
131,211,362,5,11,22,2,2,1,0,1,4,6,627,0,4,631,0,
132,191,330,3,13,25,1,0,0,3,3,4,2,575,0,7,582,0,
133,303,714,6,11,64,1,0,3,1,3,5,10,1121,0,13,1134,0,
134,289,370,3,11,33,0,5,0,1,2,3,3,720,0,19,739,0,
135,356,472,0,18,68,1,5,0,2,2,0,5,929,0,4,933,0,
136,377,489,1,11,29,1,0,0,1,1,6,9,925,0,13,938,0,
137,215,405,4,6,15,0,1,0,1,1,0,10,658,0,6,664,0,
138,330,578,5,8,127,0,3,0,2,0,2,3,1058,0,5,1063,0,
139,237,438,1,5,33,0,0,0,1,1,1,3,720,0,4,724,0,
140,246,418,3,7,37,1,2,0,1,1,4,1,721,0,12,733,0,
141,302,490,4,2,45,0,2,1,0,0,0,0,846,0,5,851,0,
142,340,354,3,6,78,1,4,0,2,0,2,5,795,0,5,800,0,
143,216,283,4,9,23,0,4,1,1,1,2,2,546,0,7,553,0,
144,226,321,1,8,20,0,5,0,0,0,1,0,582,0,7,589,0,
145,210,161,0,2,9,0,1,0,0,0,0,0,383,0,3,386,0,
146,332,616,6,8,88,0,6,1,5,3,2,4,1071,0,12,1083,0,
147,219,344,5,17,81,0,4,0,3,0,2,5,680,0,6,686,0,
148,231,380,3,4,56,0,1,1,5,2,3,5,691,0,16,707,0,
149,265,372,1,18,37,2,7,2,0,1,4,4,713,0,9,722,0,
150,287,378,3,20,63,2,1,1,0,1,1,3,760,0,10,770,0,
151,399,590,3,14,64,0,5,3,0,1,3,7,1089,0,14,1103,0,
152,295,385,5,8,30,0,5,0,0,0,2,4,734,0,9,743,0,
153,182,342,3,8,11,2,6,1,0,4,7,11,577,0,8,585,0,
154,366,351,1,11,57,0,0,0,0,0,0,1,787,0,5,792,0,
155,283,450,3,6,30,2,0,0,0,0,3,4,781,0,7,788,0,
156,237,441,6,13,66,1,3,1,0,0,2,9,779,0,10,789,0,
157,258,334,4,8,85,1,7,0,1,1,1,2,702,0,5,707,0,
158,134,216,1,8,26,0,0,0,1,0,1,2,389,0,8,397,0,
159,278,446,9,8,73,0,4,0,2,2,5,5,832,0,13,845,0,
160,262,423,5,8,93,1,1,0,0,4,1,3,801,0,5,806,0,
161,188,254,0,6,47,0,7,0,0,0,1,4,507,0,4,511,0,
162,207,291,2,16,72,1,14,1,2,1,0,2,609,0,8,617,0,
163,161,227,2,3,44,0,6,1,0,0,0,2,446,0,7,453,0,
164,248,271,3,7,28,1,3,0,1,1,0,3,566,0,9,575,0,
165,240,287,2,2,15,0,0,0,1,2,5,3,557,0,10,567,0,
166,284,241,3,2,30,0,0,0,2,0,3,0,565,0,7,572,0,
167,328,311,0,7,36,0,0,0,2,1,1,2,688,0,5,693,0,
168,242,402,5,5,116,1,1,1,3,1,5,9,791,0,12,803,0,
169,167,537,3,5,35,1,1,3,3,4,5,15,779,0,17,796,0,
170,186,474,11,7,65,0,0,1,4,5,7,10,770,0,8,778,0,
171,272,229,3,2,27,1,0,0,1,0,2,4,541,0,8,549,0,
172,222,258,2,4,68,1,0,1,1,0,3,0,560,0,7,567,0,
173,257,370,5,10,52,1,2,1,0,1,2,1,702,0,8,710,0,
174,131,236,1,7,70,0,0,1,0,2,0,0,448,0,2,450,0,
175,306,364,5,6,91,1,1,0,0,1,2,3,780,0,7,787,0,
176,229,314,3,8,70,0,1,1,0,1,0,0,627,0,8,635,0,
177,327,485,4,6,62,2,1,1,0,1,4,5,898,0,6,904,0,
178,338,397,7,3,37,1,1,2,1,2,2,4,795,0,9,804,0,
179,389,369,0,5,28,0,1,1,1,1,0,4,799,0,10,809,0,
180,328,269,1,3,19,0,1,0,2,0,0,2,625,0,4,629,0,
181,364,393,1,8,45,1,0,1,0,1,1,3,818,0,6,824,0,
182,233,300,2,10,36,0,0,1,0,3,3,2,590,0,5,595,0,
183,202,377,2,3,16,3,0,0,0,2,0,2,607,0,2,609,0,
184,222,409,4,2,34,0,1,2,0,2,1,11,688,0,13,701,0,
185,216,385,7,4,35,0,0,2,1,2,2,2,656,0,14,670,0,
186,455,328,16,24,167,0,0,3,3,2,4,4,1006,0,18,1024,0,
187,394,467,6,7,61,0,1,1,0,2,1,2,942,0,10,952,0,
188,314,310,0,7,56,1,0,0,0,0,0,3,691,0,7,698,0,
189,327,599,4,6,61,0,0,0,0,2,4,7,1010,0,11,1021,0,
190,338,397,4,5,37,0,2,0,2,2,5,5,797,0,8,805,0,
191,295,388,1,6,44,1,0,0,1,1,3,3,743,0,12,755,0,
192,315,468,5,3,29,0,2,0,0,0,3,3,828,0,7,835,0,
193,298,493,2,9,28,1,0,0,1,2,1,8,843,0,7,850,0,
194,269,318,8,2,29,1,2,0,3,1,2,3,638,0,7,645,0,
195,265,349,8,4,52,0,0,0,3,1,3,2,687,0,6,693,0,
196,273,547,1,3,51,1,1,0,2,0,0,7,886,0,9,895,0,
197,443,555,3,21,74,1,3,1,1,1,2,3,1108,0,9,1117,0,
198,356,467,3,12,19,0,0,0,0,2,5,5,869,0,15,884,0,
199,367,474,3,14,22,0,2,1,1,2,3,17,906,0,16,922,0,
200,313,667,6,4,39,0,1,0,0,2,5,10,1047,0,8,1055,0,
201,238,617,5,9,32,1,0,3,1,2,6,16,930,0,13,943,0,
202,255,202,1,11,29,0,0,0,0,0,2,2,502,0,2,504,0,
203,209,234,3,7,10,0,3,1,1,2,4,14,488,0,17,505,0,
204,310,311,4,10,38,0,11,0,0,1,2,5,692,0,8,700,0,
205,266,221,4,15,25,0,1,0,0,0,0,0,532,0,5,537,0,
206,250,381,1,12,66,0,6,2,1,0,0,1,720,0,12,732,0,
207,304,425,5,1,51,1,5,0,1,1,2,6,802,0,12,814,0,
208,216,411,4,6,13,0,2,2,1,2,2,6,665,0,6,671,0,
209,142,236,1,9,96,0,1,1,0,0,0,2,488,0,5,493,0,
210,150,229,0,4,71,1,3,0,0,0,1,1,460,0,5,465,0,
211,293,304,6,18,162,1,7,0,1,0,4,5,801,0,14,815,0,
212,236,366,6,7,99,0,1,0,0,2,0,2,719,0,6,725,0,
213,238,356,10,6,121,2,5,2,1,0,1,1,743,0,9,752,0,
214,294,510,5,10,64,1,1,2,1,3,3,3,897,0,2,899,0,
215,384,499,3,10,29,1,0,1,0,0,4,5,936,0,14,950,0,
216,279,407,1,6,18,0,0,0,0,2,1,1,715,0,3,718,0,
217,329,446,1,3,18,1,0,0,0,0,3,5,806,0,13,819,0,
218,197,586,0,0,14,0,3,2,1,1,2,4,810,0,9,819,0,
219,279,832,3,2,28,0,0,2,2,5,7,15,1175,0,8,1183,0,
220,350,520,7,5,23,0,0,0,0,4,2,5,916,0,6,922,0,
221,346,652,4,5,25,2,1,2,4,6,4,12,1063,0,12,1075,0,
222,256,616,8,6,26,1,2,1,3,3,4,6,932,0,13,945,0,
223,194,739,4,4,14,2,0,0,3,2,9,21,992,0,21,1013,0,
224,332,628,8,5,25,0,3,1,4,5,5,10,1026,0,19,1045,0,
225,244,440,6,5,13,0,1,1,1,4,7,3,725,0,8,733,0,
226,372,550,1,7,24,0,2,0,3,2,3,3,967,0,2,969,0,
227,365,447,3,13,29,2,2,0,2,0,0,2,865,0,11,876,0,
228,353,337,2,3,22,0,2,0,0,1,0,1,721,0,3,724,0,
229,199,224,1,5,5,0,1,0,0,0,0,2,437,0,2,439,0,
230,236,571,6,9,42,1,2,2,3,3,3,4,882,0,7,889,0,
231,310,438,5,6,67,0,2,0,2,3,1,3,837,0,12,849,0,
232,185,344,4,14,61,1,1,2,6,4,4,11,637,0,11,648,0,
233,168,260,2,3,28,0,0,0,1,2,1,4,469,0,3,472,0,
234,222,322,7,3,79,0,1,1,0,0,3,1,639,0,5,644,0,
235,247,274,0,0,6,0,0,1,0,1,0,1,530,0,3,533,0,
236,319,399,1,5,36,0,1,0,0,1,1,4,767,0,7,774,0,
237,436,492,5,9,13,1,0,0,2,2,1,2,963,0,12,975,0,
238,211,216,4,9,16,0,1,0,2,0,0,0,459,0,3,462,0,
239,220,282,2,7,25,2,1,0,2,3,2,2,548,0,10,558,0,
240,146,279,1,6,9,1,1,0,0,1,1,1,446,0,4,450,0,
241,351,426,2,5,10,0,2,0,0,0,2,5,803,0,12,815,0,
242,192,206,1,5,18,0,0,0,0,0,0,2,424,0,4,428,0,
243,240,352,2,9,45,1,0,2,0,0,0,1,652,0,6,658,0,
244,263,443,3,12,72,0,0,0,0,2,3,2,800,0,5,805,0,
245,250,416,4,14,29,0,0,1,0,3,1,8,726,0,9,735,0,
246,297,655,5,12,60,0,2,1,2,3,5,0,1042,0,9,1051,0,
247,147,254,1,3,15,0,0,0,1,0,1,2,424,    0  .,9,433,0,
248,259,382,3,5,26,2,0,0,0,1,1,3,682,0,8,690,0,
249,201,793,12,4,20,2,2,2,4,7,8,17,1072,0,25,1097,0,
250,297,535,4,2,28,0,0,0,2,2,1,11,882,0,12,894,0,
251,131,368,1,2,8,1,0,0,0,0,1,3,515,0,4,519,0,
252,222,441,2,7,20,0,4,0,1,1,2,3,703,0,12,715,0,
253,280,500,4,7,22,4,13,1,4,3,4,5,847,0,9,856,0,
254,286,540,5,6,5,1,2,2,0,1,4,4,856,0,7,863,0,
255,220,552,3,7,15,0,4,0,3,2,11,19,836,0,12,848,0,
256,224,477,4,7,25,2,0,0,3,3,4,7,756,0,9,765,0,
257,139,288,3,6,5,0,5,1,0,0,0,6,453,0,7,460,0,
1,548,32,7,7,75,0,0,0,1,2,0,0,672,0,1,673,0,
2,544,203,14,11,57,0,0,0,1,1,6,5,842,0,10,852,0,
3,459,513,10,13,81,1,2,2,1,3,7,1,1093,0,7,1100,0,
4,    52S,184,19,25,278,0,0,2,2,3,3,1,1045,0,4,    X049,0,
5,330,332,7,33,103,2,1,1,1,2,7,2,821,0,6,827,0,
6,381,340,10,     IS,125,1,1,0,3,4,4,10,    S97,0,11,908,0,
7,498,213,7,13,129,2,1,1,1,0,9,6,880,0,4,884,0,
8,599,26,6,14,174,0,0,0,1,2,4,1,829,0,9,838,0,
9,274,85,11,9,163,0,1,1,6,1,8,5,564,0,10,574,0,
10,338,35,10,9,181,1,0,0,2,4,3,1,584,0,5,589,0,
11,404,24,20,9,191,1,2,1,1,3,6,1,663,0,4,667,0,
12,510,77,13,7,276,2,1,1,1,6,2,1,897,0,3,900,0,
13,315,220,      g,     a,62,0,1,1,0,2,3,0,621,0,4,625,0,
14,344,182,     IB,57,276,2,1,2,5,5,3,4,399,0,8,907,0,
15,565,101,20,58,230,4,0,1,4,3,3,0,989,0,7,996,0,
16,309,343,8,6,18,0,4,1,0,3,7,6,705,0,5,710,0,
17,108,325,0,0,4,0,0,0,3,      i,2,4,447,0,4,451,0,
18,640,261,6,15,64,2,0,1,0,5,3,6,1003,0,7,1010,0,
19,121,    ei3,5,4,47,1,0,1,1,7,3,5,808,0,3,811,0,
20,167,361,1,2,16,0,0,0,0,1,1,1,550,0,3,553,0,
21,278,587,6,11,43,1,2,1,1,2,4,6,942,0,7,949,0,
72,329,    2S5,2,4,37,0,0,1,2,0,2,4,656,0,6,662,0,
23,471,163,5,15,55,0,0,0,0,2,6,1,718,0,9,727,0,
24,222,440,8,4,32,0,1,2,4,3,2,11,729,0,8,737,0,
25,    2S3,481,3,4,19,2,0,0,0,5,9,5,811,0,15,826,0,
26,402,347,2,8,7,0,0,0,1,1,2,4,774,0,14,788,0,
27,429,89,      A,3,20,0,0,0,0,2,1,0,548,0,2,550,0,
28,287,567,5,6,13,0,1,1,0,1,4,2,887,0,7,894,0,
29,215,481,    S,5,13,0,0,1,1,1,0,3,725,0,1,726,0,
30,195,185,0,4,7,1,1,0,0,0,1,3,397,0,0,397,0,
31,    36S,350,4,9,49,2,2,0,0,3,3,5,795,0,12,807,0,
32,333,130,3,1,26,0,1,0,1,0,2,1,498,0,4,502,0,
33,0,0,0,0,0,    Q,0,0,0,0,0,0,0,0,0,0,0,
34,     4D4,284,4,3,32,0,0,0,0,3,2,2,734,0,2,736,0,
35,275,358,8,0,9,0,0,1,0,1,2,2,650,0,5,661,0,
36,552,227,2,10,58,1,0,1,1,2,12,    ?,   SB6,0,18,834,0,
37,260,201,6,2,4,0,0,0,0,0,0,0,473,0,4,477,0,
38,476,53,7,60,131,0,0,0,1,1,3,3,735,0,5,740,0,
39,770,67,10,42,62,1,0,1,2,1,6,2,964,0,11,975,0,
40,635,18,9,20,96,0,0,0,1,1,2,2,784,0,7,791,0,
41,345,12,2,12,62,0,0,1,3,1,6,2,446,0,4,450,0,
42,263,638,6,3,39,0,1,0,0,1,4,3,958,0,7,965,0,
43,246,251,4,176,23,2,2,0,4,3,4,6,721,0,11,732,0,
44,163,374,5,24,20,1,4,1,1,1,3,9,606,0,9,615,0,
45,397,541,     S,22,27,1,10,3,3,3,9,14,1030,0,17,1055,0,
45,241,410,3,2,16,0,6,2,0,0,7,6,693,0,10,703,0,
47,414,372,7,25,31,0,3,0,3,2,2,5,864,0,11,875,0,
48,546,24,7,183,54,2,0,2,3,2,5,3,831,0,8,839,0,
49,237,149,6,9,41,0,0,1,0,1,2,4,450,0,5,455,0,
50,711,264,10,15,84,1,0,3,0,1,3,2,1094,0,8,1102,0,
51,303,613,2,8,21,2,2,0,2,3,    a,10,974,0,12,986,0,
52,385,435,5,7,21,1,0,0,2,3,6,12,877,0,9,886,0,
53,205,629,3,4,13,1,2,0,2,2,2,9,872,0,4,876,0,
54,418,    34S,14,66,90,1,2,1,2,3,3,9,957,   ?,14,971,0,
55,713,50,19,90,163,0,1,1,2,3,3,     S,1050,0,5,1055,0,
56,312,264,6,62,31,2,1,1,2,1,3,2,687,0,3,690,0,
     S7,518,15,4,23,47,1,0,0,2,3,5,2,620,0,5,625,0,
58,390,259,4,13,38,1,0,0,1,0,     S,8,722,0,6,728,0,
59,278,339,2,17,36,0,0,1,1,2,3,1,680,0,4,684,0,
60,107,427,1,3,28,0,0,1,0,0,2,4,653,0,1,654,0,
61,541,12,14,97,263,1,0,2,1,4,2,0,937,0,4,941,0,
62,655,3,13,25,206,0,1,0,1,1,1,2,908,0,3,911,0,
63,417,85,5,29,173,0,0,0,1,0,4,0,714,0,5,719,0,
64,162,179,5,1,21,0,0,1,1,0,4,2,396,0,10,    4oe,0,
65,663,163,15,34,152,1,1,0,2,3,6,10,1050,0,8,1058,0,
66,643,81,11,22,112,1,0,2,4,6,4,1,887,0,11,898,0,
67,357,371,3,5,11,1,0,1,0,1,1,1,752,0,7,759,0,
68,746,122,14,8,168,2,1,1,8,7,6,3,1086,0,15,   llQl,0,
69,423,    SB,3,35,80,0,0,1,0,1,0,0,631,0,6,637,0,
70,418,205,5,5,33,0,1,1,0,2,2,0,672,0,1,673,0,
71,    7ir,65,19,20,213,1,0,1,0,1,4,1,1042,0,8,1050,0,
72,788,8,14,16,170,2,1,0,3,3,6,1,1012,0,5,1017,0,
73,433,39,13,10,166,1,1,0,1,0,0,1,665,0,2,667,0,
74,772,22,25,51,217,0,1,0,1,3,6,1,1099,0,7,1106,0,
75,437,119,14,27,    ISO,3,1,3,1,2,4,2,793,0,8,801,0,
76,474,100,10,     g,47,0,2,0,1,1,1,0,651,0,6,657,0,
77,331,305,10,7,41,0,0,1,1,0,3,3,702,0,4,706,0,
78,613,143,10,12,177,0,0,1,3,5,5,2,971,0,11,982,0,
79,449,389,9,8,49,0,0,3,5,4,2,4,922,0,10,932,0,
80,666,21,20,56,145,1,3,1,4,2,5,1,925,0,13,938,0,
81,526,84,6,15,31,0,0,1,0,0,4,1,   66S,0,5,673,0,
82,463,202,8,25,84,2,3,0,2,2,8,1,800,0,3,303,0,
83,941,83,2,19,33,0,1,1,5,4,7,4,1100,0,10,1110,0,
84,770,13,13,6,46,1,0,1,0,4,2,1,857,0,13,870,0,
85,447,260,18,21,146,2,4,0,2,2,5,6,913,0,12,925,0,
86,316,261,10,4,70,2,0,0,3,0,2,1,669,0,7,676,0,
87,163,265,5,3,47,0,0,2,1,0,0,4,490,0,2,492,0,
88,323,339,13,6,105,1,3,0,1,2,3,1,797,0,13,810,0,
89,434,200,3,11,31,0,0,0,0,1,2,0,682,0,6,    68S,0,
90,502,     S,5,9,35,0,0,1,1,1,3,0,565,0,6,571,0,
91,444,91,10,18,106,1,0,0,0,4,1,2,677,0,7,684,0,
92,355,600,3,12,24,1,0,0,5,1,3,6,1010,0,15,1025,0,
93,423,292,12,27,175,2,1,1,1,2,2,4,942,0,11,953,0,
     9A,349,481,5,3,26,0,2,0,5,3,7,7,888,0,10,898,0,
95,130,204,1,0,11,2,0,0,0,1,1,0,350,0,3,353,0,
96,256,317,2,8,40,0,0,1,0,2,1,4,631,0,8,639,0,
97,443,209,7,11,149,1,0,1,0,1,5,6,633,0,4,837,0,
98,166,340,2,5,7,2,0,0,4,3,5,7,541,0,12,553,0,
99,444,    loa,8,10,77,1,0,1,3,1,6,4,663,0,6,669,0,
100,406,     IS,9,4,75,0,0,0,1,1,0,0,514,0,4,518,0,
101,425,114,6,15,123,1,2,0,0,0,3,1,690,0,5,695,0,
102,666,8,10,24,111,1,1,0,3,0,6,1,831,0,3,834,0,
103,432,481,9,7,56,0,2,0,3,1,6,3,999,0,6,1005,0,
104,597,53,0,21,109,1,1,0,0,2,0,0,790,0,12,802,0,
105,245,375,1,4,37,1,0,0,0,0,1,3,667,0,5,672,0,
106,194,465,6,3,11,0,0,0,1,3,6,9,698,0,14,712,0,
107,207,301,9,3,2,0,0,0,0,1,2,3,528,0,2,530,0,
108,    35S,530,2,5,21,1,0,0,3,1,5,8,840,0,19,859,0,
109,464,395,3,11,16,1,1,3,2,6,5,5,912,0,3,920,0,
110,    eo5,44,7,22,157,2,1,2,1,0,3,1,845,0,11,856,0,
111,461,95,     IS,     sa,250,1,2,2,2,0,1,1,891,0,8,899,0,
112,374,663,2,7,74,1,0,0,1,1,5,6,1134,0,     S,1142,0,
113,370,674,5,11,28,0,4,0,1,1,8,6,1108,0,10,1118,0,
114,397,79,6,36,78,0,0,1,3,2,3,3,    60S,0,10,618,0,
115,564,10,6,36,90,1,0,0,0,1,1,1,710,0,4,714,0,
116,622,166,8,16,66,0,0,0,0,6,3,0,887,0,8,895,0,
117,337,84,3,2,12,0,0,1,0,2,1,3,445,0,1,446,0,
113,293,190,6,2,92,0,1,0,2,3,5,0,594,0,4,598,0,
119,270,261,6,9,79,0,2,1,0,0,3,2,633,0,3,630,0,
120,427,326,11,13,100,2,0,1,2,0,5,5,892,0,4,896,0,
121,219,457,8,26,95,0,0,0,3,7,5,2,   B22,0,5,827,0,
122,335,357,4,9,17,0,1,4,3,1,5,6,742,0,    S,750,0,
123,500,120,3,9,111,0,0,0,1,0,1,3,748,0,1,749,0,
124,557,23,5,25,87,0,0,1,0,0,2,0,700,0,3,703,0,
125,157,605,11,2,23,2,2,4,2,2,1,9,820,0,8,828,0,
126,102,415,7,4,     IS,0,1,0,0,1,3,4,612,0,2,614,0,
127,199,436,14,0,16,0,1,0,1,3,1,2,673,0,3,676,0,
128,    23?,436,6,2,11,1,0,0,1,4,7,7,757,0,8,765,0,
129,313,529,8,     S,66,0,1,2,2,1,2,9,941,0,9,   9&0,0,
130,295,443,1,4,17,0,0,1,0,4,0,3,768,0,13,781,0,
131,406,176,12,5,135,1,0,0,1,0,0,1,739,0,4,743,0,
132,467,243,16,53,129,3,1,1,1,4,1,2,921,0,2,923,0,
133,216,507,5,3,25,0,0,1,0,0,5,7,769,0,3,772,0,
134,725,148,9,     a,154,1,1,1,1,4,2,2,1066,0,8,1064,0,
135,802,74,4,15,60,0,1,0,2,1,6,1,966,0,3,974,0,
136,90,465,8,3,     7S,0,1,0,4,6,6,8,689,0,6,695,0,
137,108,470,3,3,36,0,0,1,2,2,1,2,628,0,1,629,0,
     13S,175,524,5,3,45,0,1,0,0,3,3,1,763,0,1,770,0,
139,216,420,4,4,36,1,0,0,0,1,3,0,685,0,2,687,0,
140,176,297,0,11,16,1,0,1,1,2,0,1,506,0,9,515,0,
141,1112,13,9,22,73,2,0,1,2,3,5,0,1247,0,     S,1252,0,
142,339,104,      S,24,27,0,0,0,2,1,4,1,507,0,5,512,0,
143,240,555,3,5,27,1,1,0,0,0,2,4,838,0,6,844,0,
144,425,640,1,2,29,0,0,1,1,0,7,8,1114,0,18,1132,0,
145,346,689,3,2,16,0,0,0,1,1,7,5,1070,0,4,1074,0,
146,295,498,6,6,40,1,0,0,1,3,0,3,853,0,3,861,0,
147,519,     IS,3,76,49,0,0,2,1,0,3,2,670,0,4,674,0,
143,419,17,3,41,50,2,0,0,3,2,2,0,539,0,2,541,0,
149,419,26,      S,20,45,1,0,0,0,2,2,2,525,0,3,528,0,
150,314,221,2,23,52,0,0,0,1,1,2,1,617,0,4,621,0,
151,343,482,2,1,21,0,0,0,1,0,3,3,856,0,2,858,0,
152,345,434,4,12,42,2,8,1,3,4,5,6,866,0,8,874,0,
153,295,350,2,6,34,0,20,1,0,1,3,3,715,0,8,723,0,
154,389,571,5,7,17,1,3,0,3,1,1,0,998,0,4,1002,0,
155,452,616,3,5,38,1,3,2,0,3,4,5,1132,0,10,1142,0,
156,450,    All,6,11,53,1,2,2,0,0,5,6,1038,0,13,1051,0,
157,257,      3&5,3,10,36,0,1,2,0,2,3,7,716,0,3,719,0,
158,201,271,3,5,27,2,1,0,0,0,0,0,510,0,5,515,0,
159,497,    3S9,2,15,4.2,0,6,1,2,2,5,3,964,0,10,974,0,
160,290,366,2,7,67,1,2,0,0,4,6,7,752,0,14,766,0,
161,326,552,6,25,38,0,3,1,3,3,3,3,963,0,11,974,0,
162,220,340,5,     S,44,2,0,2,0,3,4,2,630,0,3,633,0,
163,    4S7,564,7,14,83,1,6,1,1,0,2,4,1170,0,16,1186,0,
164,290,379,3,17,    AO,0,2,2,0,1,0,5,739,0,4,743,0,
165,460,591,7,22,40,0,10,0,3,2,2,5,1142,0,12,1154,0,
166,268,329,2,10,137,0,0,0,0,0,1,1,748,0,9,757,0,
167,248,213,2,16,74,0,1,0,1,1,1,1,558,0,4,562,0,
168,230,227,3,6,78,1,0,1,1,1,3,5,556,0,5,561,0,
169,248,242,5,10,95,1,1,2,1,2,3,2,612,0,5,617,0,
170,161,267,4,3,     S6,1,2,2,0,2,1,1,530,0,4,534,0,
171,407,494,10,23,78,1,1,1,4,2,1,2,1024,0,8,1032,0,
172,354,313,4,16,49,1,1,1,1,4,6,1,751,0,6,757,0,
173,426,317,5,14,43,0,0,0,3,4,3,4,819,0,   IS,834,0,
174,263,416,5,7,84,2,0,1,1,4,1,1,785,0,8,793,0,
175,190,296,0,5,31,1,1,1,0,1,2,0,528,0,7,535,0,
176,207,346,4,5,47,1,1,0,2,2,2,3,620,0,6,626,0,
177,426,436,4,5,64,0,1,1,3,2,2,1,945,0,16,960,0,
178,424,   S59,6,17,55,0,3,0,0,4,1,3,1072,0,20,1092,0,
179,232,347,6,5,53,2,2,1,3,2,1,1,655,0,8,663,0,
   ISO,269,603,    S,5,33,4,0,6,5,4,12,5,958,0,11,969,0,
181,   31S,512,3,7,19,2,1,1,3,2,1,1,876,0,17,893,0,
182,175,300,6,2,60,0,0,1,2,0,4,6,556,0,5,561,0,
183,233,245,2,8,57,1,1,0,1,2,3,2,555,0,7,562,0,
184,232,215,1,10,31,0,1,1,0,1,2,3,497,0,4,501,0,
   1S5,447,452,14,10,107,0,0,0,1,3,8,4,1046,0,13,1059,0,
186,157,126,2,4,39,0,0,0,1,0,2,0,331,0,7,   33S,0,
187,325,254,4,30,66,0,1,1,2,1,0,3,687,0,16,703,0,
136,230,267,2,14,92,0,0,0,0,4,2,1,612,0,5,617,0,
189,270,367,6,25,56,2,0,1,0,1,3,4,735,0,6,741,0,
    Â±QQ,314,256,6,36,67,1,0,0,0,1,0,3,684,0,6,690,0,
191,327,359,4,24,93,0,5,2,1,3,1,2,821,0,11,    G32,0,
192,373,467,2,11,46,0,0,0,1,2,2,1,905,0,5,910,0,
193,278,227,1,5,65,1,2,0,0,0,0,1,   5S0,0,8,588,0,
194,349,341,2,     IS,82,1,1,0,0,2,2,3,   BOl,0,10,811,0,
135,221,411,3,10,34,0,0,1,3,4,3,12,702,0,6,708,0,
196,276,503,4,14,46,0,2,0,0,1,0,1,847,0,9,856,0,
197,,256,2,23,42,0,1,1,2,0,1,1,617,0,14,631,0,
    Ids,320,512,6,10,63,0,0,2,0,1,2,6,922,0,8,930,0,
199,147,427,0,6,59,0,0,0,2,1,2,4,648,0,3,661,0,
200,181,202,1,6,     4S,1,1,0,1,0,2,1,504,0,8,512,0,
201,210,316,5,20,109,1,1,0,2,0,0,0,664,0,6,570,0,
202,223,354,1,28,131,1,3,2,3,     s,1,5,757,0,5,762,0,
203,192,267,8,     Q,74,1,0,1,1,1,1,1,556,0,6,562,0,
204,146,245,5,9,54,1,0,0,1,0,0,1,462,0,7,469,0,
205,333,458,4,16,96,2,2,1,4,0,1,7,924,0,8,932,0,
206,324,310,1,22,26,1,0,0,1,1,0,3,689,0,5,694,0,
207,319,289,2,10,32,0,2,1,0,0,0,3,658,0,12,670,0,
208,417,421,4,34,67,1,0,0,3,4,1,4,956,0,10,966,0,
209,380,356,6,14,88,2,0,0,3,4,     i,3,857,0,10,867,0,
210,135,132,0,12,34,0,1,1,0,2,1,1,319,0,7,326,0,
211,269,204,0,13,107,0,2,1,0,0,0,1,597,0,8,605,0,
212,317,256,    X,3,52,0,0,0,1,0,0,4,634,0,8,642,0,
213,162,132,1,6,99,0,0,0,0,1,0,1,402,0,5,407,0,
214,331,245,2,23,69,1,0,1,1,1,0,0,674,0,13,687,0,
215,389,245,10,20,104,0,1,2,2,3,0,0,776,0,    g,785,0,
216,246,382,7,6,94,2,1,0,2,4,4,7,755,0,17,772,0,
217,381,401,10,8,203,2,1,2,4,3,4,9,1028,0,11,1039,0,
    21B,278,386,5,14,131,2,3,1,5,4,3,4,836,0,3,844,0,
219,286,324,7,5,78,0,2,2,7,3,3,7,724,0,5,729,0,
220,244,319,4,8,73,1,3,2,1,2,2,5,664,0,3,667,0,
221,223,287,2,17,142,0,2,0,2,2,1,2,680,0,23,703,0,
222,363,   2S5,3,21,   lis,2,0,1,1,1,1,2,   79S,0,10,   80S,0,
223,118,99,1,10,44,0,0,0,0,0,0,0,272,0,7,279,0,
224,   29S,314,3,18,    es,0,0,0,0,1,1,1,701,0,4,705,0,
225,172,203,2,7,48,0,0,0,3,0,0,1,436,0,4,440,0,
226,278,319,3,10,21,0,1,1,0,1,2,0,636,0,4,640,0,
227,295,139,1,17,27,1,1,1,0,0,0,1,483,0,5,   4BS,0,
226,334,308,4,12,43,0,1,0,0,0,0,3,725,0,13,   73S,0,
229,192,165,1,27,56,1,2,1,2,0,0,0,447,0,6,453,0,
230,301,285,4,3,42,1,0,0,1,0,0,4,641,0,5,646,0,
231,434,293,5,42,    S7,0,0,0,0,1,0,0,862,0,10,   S72,0,
232,309,270,6,22,121,2,0,0,3,1,3,2,739,0,12,751,0,
233,314,   27B,7,14,77,1,0,1,0,1,1,0,694,0,14,708,0,
234,164,115,2,13,74,0,1,0,0,0,1,0,371,0,9,380,0,
235,   Z4S,179,2,7,117,0,0,1,0,    a,0,0,554,0,7,561,0,
236,228,271,5,4,   sa,1,2,    ?,0,3,0,2,574,0,6,580,0,
237,276,319,4,13,56,2,0,1,0,2,2,1,676,0,8,   6Â£4,0,
238,329,    3m,      A,8,139,1,2,1,0,4,1,1,   S79,0,3,882,0,
239,195,    26?,3,4,    5S,0,0,0,0,1,0,1,531,0,5,536,0,
340,220,239,6,9,77,0,3,0,2,1,1,5,563,0,7,570,0,
241,314,412,7,14,95,2,0,2,2,3,     e,3,   S60,0,6,866,0,
242,275,343,2,4,71,3,0,0,0,0,3,3,704,0,6,710,0,
243,307,   3S4,5,8,30,1,1,0,1,1,2,2,762,0,10,772,0,
244,199,145,4,10,    T7,0,0,1,0,0,1,1,   43S,0,8,446,0,
245,298,224,2,13,71,1,0,0,0,1,0,0,610,0,11,   S21,0,
246,313,327,4,11,109,0,0,0,1,1,0,0,766,0,11,777,0,
247,394,593,10,9,52,0,0,1,2,4,2,3,1070,0,8,1078,0,
    24S,158,356,5,11,20,1,0,2,2,4,3,2,570,0,    S,   57S,0,
249,68,124,3,3,11,0,1,0,0,2,1,4,217,0,1,218,0,
250,323,463,6,20,86,2,2,0,3,0,1,0,906,0,21,   B27,0,
251,159,250,5,     e,40,0,1,2,2,5,2,3,475,0,9,484,0,
252,224,540,6,9,66,0,0,1,0,3,2,1,852,0,10,   S62,0,
253,102,395,11,6,104,0,0,1,0,5,2,2,   62S,0,    e,634,0,
254,160,332,21,14,    5S,1,1,0,0,2,1,1,591,0,3,594,0,
255,151,   2S9,    IS,0,29,2,0,0,2,2,0,1,494,0,5,499,0,
256,163,281,6,6,44,0,0,1,2,1,0,1,504,0,4,508,0,
257,210,544,   S,9,101,0,0,1,6,4,0,4,  B87,0,7,894,0,
   25S,217,532,13,5,172,1,0,1,    e,5,4,2,  95S,0,13,971,0,
259,153,394,5,7,53,0,0,1,0,4,3,6,626,0,2,628,0,
260,121,  45S,5,2,26,0,0,0,2,1,1,2,  6 IS,0,2,620,0,
261,315,675,14,9,170,1,1,3,5,5,9,7,1114,0,9,1123,0,
262,195,377,   S,3,61,3,0,0,2,5,7,5,666,0,9,675,0,
263,353,425,16,11,179,0,0,2,4,4,6,4,1009,0,12,1021,0,
264,198,604,6,7,140,2,0,3,5,5,3,11,984,0,12,996,0,
265,443,430,9,16,151,2,1,2,2,4,1,    &,1069,0,7,1076,0,
266,210,533,2,3,41,1,0,0,0,1,5,   ?S,4,0,8,  S12,0,
   2S7,  23D,703,7,5,48,0,0,1,0,1,2,4,996,0,3,999,0,
1,256,580,2,12,13,0,1,0,2,9,3,6,884,0,8,892,0,
2,222,535,2,7,14,0,0,1,0,4,3,7,795,0,12,807,0,
3,158,342,2,16,29,0,1,0,0,1,4,4,557,0,4,561,0,
4,136,433,0,6,7,0,1,0,1,2,2,6,594,0,6,600,0,
5,239,669,2,18,29,2,0,0,5,8,3,7,982,0,10,992,0,
6,699,33,6,70,58,1,1,1,1,1,0,0,871,0,11,882,0,
7,366,171,2,29,27,1,2,1,1,1,2,2,605,0,4,609,0,
8,192,416,7,4,25,1,1,2,2,9,4,6,669,0,7,676,0,
9,206,422,3,9,25,1,0,1,1,4,6,6,684,0,11,695,0,
10,851,39,9,74,60,1,0,1,3,2,4,4,1048,0,21,1069,0,
11,877,55,12,92,80,0,3,0,2,3,1,4,1129,0,24,1153,0,
12,501,53,1,36,13,1,0,0,0,2,3,4,614,0,18,632,0,
13,266,587,3,17,35,1,0,4,1,1,3,10,928,0,16,944,0,
14,840,30,4,57,14,1,1,1,0,4,4,3,959,0,37,996,0,
15,532,147,5,41,31,1,0,1,1,2,3,1,765,0,5,770,0,
16,290,339,5,8,82,1,0,0,3,0,2,4,734,0,8,742,0,
17,458,449,4,2,45,1,0,0,1,1,3,8,972,0,23,995,0,
18,333,261,5,7,31,0,0,0,3,1,2,7,650,0,10,660,0,
19,427,399,5,4,42,0,0,0,0,2,2,6,887,0,11,898,0,
20,376,15,6,49,54,0,0,1,1,1,0,2,505,0,7,512,0,
21,214,478,6,14,35,1,0,0,3,3,3,5,762,0,5,767,0,
22,183,605,6,6,44,0,1,4,5,7,4,13,878,0,32,910,0,
23,734,27,6,41,35,2,1,0,0,3,3,7,859,0,11,870,0,
24,585,20,5,45,49,3,0,0,1,3,3,5,719,0,21,740,0,
25,925,16,6,31,51,3,1,2,4,3,3,4,1049,0,27,1076,0,
26,473,116,7,27,54,1,1,1,2,1,2,5,690,0,16,706,0,
27,461,33,4,17,62,0,1,1,1,4,2,2,588,0,13,601,0,
28,268,321,2,4,55,2,0,0,1,1,0,2,656,0,10,666,0,
29,211,195,0,8,51,0,3,1,0,2,1,1,473,0,6,479,0,
30,414,263,1,5,50,1,0,0,1,2,1,2,740,0,11,751,0,
31,332,185,2,4,11,0,0,0,0,0,0,1,535,0,7,542,0,
32,519,402,5,14,35,1,2,0,1,0,0,4,983,0,12,995,0,
33,909,15,3,20,5,0,0,0,0,0,0,0,952,0,8,960,0,
34,922,75,3,34,14,1,2,1,0,1,2,1,1056,0,4,1060,0,
35,407,456,7,13,107,3,2,1,1,5,2,4,1008,0,17,1025,0,
36,292,276,2,13,64,0,0,0,0,1,2,1,651,0,9,660,0,
37,341,137,1,14,9,0,0,0,0,0,0,0,502,0,3,505,0,
38,288,151,1,3,10,0,0,0,1,1,0,1,456,0,7,463,0,
39,321,176,3,5,50,0,0,0,0,0,1,3,559,0,10,569,0,
40,318,183,1,9,67,0,0,0,0,0,3,3,584,0,6,590,0,
41,472,289,1,8,21,0,1,0,1,1,0,4,798,0,12,810,0,
42,726,56,10,19,17,1,0,0,0,1,0,2,832,0,15,847,0,
43,623,192,7,25,45,0,1,2,1,1,3,3,903,0,16,919,0,
44,144,112,2,5,4,0,0,0,1,0,3,2,273,0,4,277,0,
45,412,193,3,7,30,0,2,1,0,1,0,1,650,0,8,658,0,
46,290,358,3,24,28,0,0,0,1,1,1,2,708,0,3,711,0,
47,272,401,2,21,36,1,0,1,1,2,1,2,740,0,12,752,0,
48,229,283,2,7,27,0,0,2,0,1,1,2,554,0,8,562,0,
49,432,407,7,12,65,0,1,1,0,3,3,6,937,0,4,941,0,
50,255,394,8,12,95,1,0,1,2,0,2,4,774,0,3,777,0,
51,216,389,7,15,74,0,3,2,2,1,2,3,714,0,7,721,0,
52,372,154,7,49,38,0,0,2,0,3,2,1,628,0,9,637,0,
53,368,120,1,36,18,1,1,1,1,2,1,1,551,0,8,559,0,
54,243,358,0,16,33,0,0,2,2,3,2,1,660,0,4,664,0,
55,420,315,0,21,70,0,1,0,1,0,3,2,833,0,10,843,0,
56,365,118,11,22,105,3,1,1,1,2,2,1,632,0,10,642,0,
57,531,124,8,38,77,1,3,1,0,2,0,4,789,0,2,791,0,
58,495,142,5,33,49,0,1,1,2,3,2,4,737,0,15,752,0,
59,482,141,5,26,30,2,0,1,1,3,3,2,696,0,11,707,0,
60,573,46,7,19,55,0,0,1,0,1,2,1,705,0,6,711,0,
61,202,328,1,25,30,1,0,0,1,0,2,1,591,0,14,605,0,
62,399,59,3,15,27,0,0,1,0,0,1,0,505,0,5,510,0,
63,209,272,3,14,53,0,1,0,2,2,0,4,560,0,14,574,0,
64,237,303,4,14,56,2,0,0,2,1,0,5,624,0,7,631,0,
65,332,134,5,32,54,2,1,0,0,0,1,1,562,0,6,568,0,
66,191,447,3,16,21,1,1,0,0,1,0,3,684,0,3,687,0,
67,351,416,2,27,30,1,0,0,2,2,3,1,835,0,4,839,0,
68,318,328,6,13,44,2,1,0,0,1,0,3,716,0,10,726,0,
69,461,69,0,20,56,0,0,0,1,1,2,1,611,0,7,618,0,
70,422,48,6,9,53,0,1,0,1,2,1,4,547,0,6,553,0,
71,484,96,1,35,117,0,0,0,0,1,1,0,735,0,3,738,0,
72,507,168,5,33,116,2,1,2,9,3,4,6,856,0,10,866,0,
73,179,248,0,9,10,0,2,0,1,3,1,2,455,0,7,462,0,
74,389,146,4,7,30,1,0,1,3,1,1,2,585,0,10,595,0,
75,372,80,4,3,41,0,2,2,1,2,0,3,510,0,8,518,0,
76,517,30,1,11,31,0,0,0,0,1,2,0,593,0,7,600,0,
77,522,74,1,12,31,2,1,1,2,1,1,0,648,0,7,655,0,
78,811,60,3,23,37,1,0,0,1,5,3,3,947,0,15,962,0,
79,492,23,2,15,24,0,1,3,1,0,3,3,567,0,13,580,0,
80,389,142,5,15,26,0,1,0,0,1,1,6,586,0,11,597,0,
81,565,145,5,36,27,1,0,0,2,1,3,5,790,0,22,812,0,
82,218,420,5,39,16,1,3,1,3,2,3,10,721,0,13,734,0,
83,184,371,5,57,14,0,0,0,1,1,3,1,637,0,11,648,0,
84,242,369,1,32,20,3,1,0,2,2,3,2,677,0,4,681,0,
85,283,415,3,31,56,0,0,0,0,1,2,1,792,0,20,812,0,
86,281,454,4,36,42,2,1,2,1,1,1,6,831,0,15,846,0,
87,314,607,1,22,24,0,0,0,0,5,1,6,980,0,12,992,0,
88,152,326,2,21,32,0,0,1,2,5,3,4,548,0,8,556,0,
89,144,311,1,23,25,0,2,3,2,2,0,2,515,0,8,523,0,
90,185,407,1,23,31,1,0,2,1,0,1,0,652,0,9,661,0,
91,137,209,1,10,33,1,0,0,0,0,1,2,394,0,7,401,0,
92,190,635,5,21,39,3,2,0,1,2,1,3,902,0,6,908,0,
93,250,364,4,22,28,1,0,0,1,1,0,2,673,0,9,682,0,
94,205,399,4,17,18,0,3,0,4,1,2,3,656,0,8,664,0,
95,256,452,1,26,26,1,1,1,0,0,0,6,770,0,10,780,0,
96,350,470,8,11,52,0,0,0,2,4,1,6,904,0,13,917,0,
97,175,220,0,9,46,0,0,0,1,2,1,0,454,0,7,461,0,
98,245,420,3,14,58,0,0,0,2,0,1,2,745,0,4,749,0,
99,304,573,2,16,38,0,0,1,0,4,3,4,945,0,9,954,0,
100,229,418,5,10,21,0,0,0,0,2,2,2,689,0,2,691,0,
101,333,656,4,8,47,2,1,1,1,3,0,4,1060,0,7,1067,0,
102,272,421,7,16,123,1,2,0,5,5,7,4,863,0,15,878,0,
103,221,467,2,8,52,1,2,0,4,10,5,0,772,0,7,779,0,
104,210,586,13,4,65,1,0,3,3,8,5,10,908,0,7,915,0,
105,332,463,4,12,65,0,0,1,0,2,2,4,885,0,1,886,0,
106,162,352,0,4,20,0,0,1,1,4,5,4,553,0,2,555,0,
107,151,368,4,7,25,0,1,0,3,5,5,4,573,0,8,581,0,
108,246,490,4,6,45,0,0,0,0,3,2,4,800,0,7,807,0,
109,164,490,6,4,27,1,0,0,0,3,5,8,708,0,7,715,0,
110,138,416,5,4,30,0,2,1,2,1,2,3,604,0,6,610,0,
111,210,612,4,4,57,0,1,0,1,5,2,8,904,0,15,919,0,
112,228,465,6,1,40,1,0,1,1,3,0,5,751,0,16,767,0,
113,203,471,4,1,51,0,0,0,1,1,6,8,746,0,7,753,0,
114,369,662,4,8,80,2,2,3,2,8,4,13,1157,0,12,1169,0,
115,243,682,2,7,10,1,0,2,1,2,0,9,959,0,8,967,0,
116,195,676,5,1,58,1,0,0,4,3,4,6,953,0,10,963,0,
117,417,520,8,8,51,0,0,2,3,3,9,13,1034,0,17,1051,0,
118,469,24,4,47,150,1,1,0,1,5,1,1,704,0,3,707,0,
119,665,32,4,22,36,2,1,1,3,0,1,3,770,0,12,782,0,
120,546,315,2,36,47,0,0,0,0,2,0,1,949,0,16,965,0,
121,830,43,8,67,101,2,0,3,6,5,4,2,1071,0,16,1087,0,
122,314,286,4,13,29,1,0,0,0,0,2,0,649,0,9,658,0,
123,291,263,0,7,27,0,1,0,0,3,4,1,597,0,10,607,0,
124,714,57,4,41,74,0,0,3,2,0,2,2,899,0,15,914,0,
125,424,16,3,46,51,2,1,2,1,3,2,1,552,0,8,560,0,
126,469,475,4,30,37,1,0,0,2,0,0,3,1021,0,13,1034,0,
127,238,264,3,24,58,0,1,0,2,1,1,2,594,0,14,608,0,
128,222,276,4,7,42,0,0,0,1,2,1,1,556,0,12,568,0,
129,584,36,4,20,100,0,1,0,1,1,0,0,747,0,6,753,0,
130,485,360,2,25,30,0,0,0,0,2,2,0,906,0,11,917,0,
131,356,277,0,18,27,2,0,0,1,2,1,0,684,0,6,690,0,
132,226,202,1,8,10,0,0,2,0,2,1,6,458,0,2,460,0,
133,701,84,5,56,65,1,0,0,2,0,2,2,918,0,13,931,0,
134,362,205,2,23,24,0,0,0,0,2,1,4,623,0,7,630,0,
135,275,421,4,20,38,1,0,0,3,1,5,4,772,0,11,783,0,
136,244,430,3,11,44,0,0,0,1,2,0,0,735,0,4,739,0,
137,224,242,2,2,19,1,0,0,0,0,0,0,490,0,3,493,0,
138,359,366,2,31,36,0,2,0,1,2,0,2,801,0,19,820,0,
139,487,367,3,4,27,0,0,1,2,0,0,4,895,0,10,905,0,
140,308,413,12,12,40,1,0,1,2,2,5,13,809,0,12,821,0,
141,638,46,5,14,55,1,0,1,4,0,5,4,773,0,8,781,0,
142,271,6,12,14,69,0,1,0,1,2,2,0,378,0,0,378,0,
143,534,331,2,42,54,1,0,0,0,0,3,3,970,0,7,977,0,
144,850,58,18,28,154,2,1,2,0,6,7,4,1130,0,9,1139,0,
145,249,274,0,4,27,0,0,0,0,1,0,0,555,0,7,562,0,
146,552,271,2,52,68,1,1,1,0,1,2,3,954,0,16,970,0,
147,761,45,11,30,102,2,0,1,3,2,4,2,963,0,12,975,0,
148,528,60,16,11,470,2,4,5,20,10,6,6,1138,0,24,1162,0,
149,305,438,1,11,78,0,0,0,0,0,2,3,838,0,12,850,0,
150,597,171,18,32,118,4,2,1,8,10,8,3,972,0,17,989,0,
151,355,17,10,33,89,2,0,0,0,1,5,2,514,0,6,520,0,
152,378,229,8,37,103,0,0,1,1,0,2,7,766,0,15,781,0,
153,341,558,4,7,73,2,1,1,2,1,1,2,993,0,8,1001,0,
154,393,397,2,12,30,0,1,1,5,2,5,6,854,0,8,862,0,
155,638,71,15,31,178,4,1,1,1,2,1,1,944,0,11,955,0,
156,487,7,8,14,134,2,1,1,3,3,3,1,664,0,8,672,0,
157,543,25,18,19,137,2,3,2,2,11,4,5,771,0,14,785,0,
158,340,420,3,23,35,0,1,0,1,1,1,4,829,0,16,845,0,
159,213,568,4,10,11,2,0,0,1,5,5,7,826,0,10,836,0,
160,790,25,6,36,100,6,0,1,0,3,6,6,979,0,16,995,0,
161,543,12,2,25,34,0,1,0,0,2,0,1,620,0,11,631,0,
162,338,230,14,9,223,0,4,4,4,2,1,4,833,0,4,837,0,
163,351,14,8,26,70,4,1,3,0,4,2,2,485,0,4,489,0,
164,351,575,8,10,115,1,2,1,2,1,3,3,1072,0,10,1082,0,
165,405,9,11,19,166,2,0,1,2,1,2,0,618,0,3,621,0,
166,657,17,6,39,130,2,2,2,3,0,7,1,866,0,9,875,0,
167,469,10,11,37,96,0,1,1,0,1,1,1,628,0,4,632,0,
168,676,20,9,33,61,1,0,0,0,2,4,0,806,0,8,814,0,
169,726,6,3,30,18,0,0,1,0,1,1,1,787,0,9,796,0,
170,577,461,5,14,14,0,0,1,0,1,5,4,1082,0,15,1097,0,
171,473,388,1,35,31,1,0,1,1,2,4,6,943,0,14,957,0,
172,209,474,4,5,4,0,1,0,3,2,2,11,715,0,5,720,0,
173,448,29,1,408,22,6,0,1,3,1,3,7,929,0,8,937,0,
174,421,16,2,81,17,2,0,0,0,1,2,0,542,0,3,545,0,
175,503,10,4,84,19,3,0,1,1,1,2,1,629,0,2,631,0,
176,449,338,1,22,17,0,0,0,0,2,4,3,836,0,9,845,0,
177,491,8,4,14,44,1,0,1,1,5,3,0,572,0,3,575,0,
178,447,8,6,11,35,0,0,1,1,2,1,0,512,0,0,512,0,
179,640,16,3,62,104,2,1,0,3,3,2,2,838,0,11,849,0,
180,554,26,5,33,77,2,1,0,2,8,2,4,714,0,7,721,0,
181,434,10,3,34,35,1,0,0,0,0,1,0,518,0,5,523,0,
182,153,533,4,26,30,1,0,1,2,6,4,6,766,0,4,770,0,
183,838,21,5,59,26,2,0,0,3,3,6,4,967,0,15,982,0,
184,417,44,11,87,131,3,1,3,1,4,2,1,705,0,7,712,0,
185,252,9,7,99,54,1,0,1,0,1,0,2,426,0,3,429,0,
186,488,8,2,35,16,3,1,0,0,0,4,0,557,0,9,566,0,
187,451,43,4,46,18,4,0,0,3,0,1,3,573,0,8,581,0,
188,252,692,1,18,42,2,1,1,1,2,1,2,1015,0,6,1021,0,
189,278,372,2,11,14,1,1,1,1,2,1,2,686,0,5,691,0,
190,331,390,3,3,3,0,0,0,0,0,4,5,739,0,5,744,0,
191,229,604,5,8,104,0,0,0,1,3,3,2,959,0,9,968,0,
192,202,439,4,10,36,1,1,0,2,1,2,4,702,0,3,705,0,
193,234,425,2,10,41,2,0,0,2,2,4,6,728,0,12,740,0,
194,660,188,14,72,145,6,0,3,0,3,5,2,1098,0,15,1113,0,
195,181,375,6,1,51,0,0,0,5,4,2,6,631,0,5,636,0,
196,223,328,2,1,10,0,0,0,2,2,0,5,573,0,9,582,0,
197,153,708,7,6,36,0,0,1,2,1,5,3,922,0,13,935,0,
198,158,404,2,5,20,1,0,0,0,1,4,10,605,0,9,614,0,
199,366,9,3,3,22,1,0,1,0,1,0,2,408,0,5,413,0,
200,215,770,6,4,62,1,3,2,1,3,7,4,1078,0,16,1094,0,
201,349,422,1,3,10,2,0,1,0,1,1,6,796,0,8,804,0,
202,263,301,14,2,136,1,1,0,2,2,4,2,728,0,8,736,0,
203,432,438,14,6,98,1,1,0,0,3,1,10,1004,0,9,1013,0,
204,253,333,0,3,4,0,1,2,0,0,1,1,598,0,3,601,0,
205,624,392,14,28,50,1,0,2,3,4,6,9,1133,0,15,1148,0,
206,141,453,9,9,71,0,2,1,2,3,7,13,711,0,9,720,0,
207,284,232,9,5,78,0,0,3,6,7,10,5,639,0,20,659,0,
208,860,18,5,47,70,0,0,0,2,0,0,0,1002,0,10,1012,0,
209,256,235,7,7,10,1,0,1,1,1,1,1,521,0,6,527,0,
210,478,112,12,10,110,4,1,1,3,0,6,1,738,0,4,742,0,
211,591,67,7,37,106,0,0,3,2,4,5,0,822,0,10,832,0,
212,395,434,10,7,84,1,1,2,11,6,9,10,970,0,16,986,0,
213,467,88,14,17,102,0,0,1,4,4,3,5,705,0,7,712,0,
214,522,110,17,16,129,0,1,2,3,5,5,3,813,0,9,822,0,
215,281,231,4,7,29,1,0,1,3,3,2,3,565,0,14,579,0,
216,247,577,4,9,55,1,2,2,2,4,2,3,908,0,9,917,0,
217,413,303,11,13,64,2,1,0,2,2,5,3,819,0,18,837,0,
218,385,462,16,6,60,0,0,0,2,3,4,6,944,0,13,957,0,
219,804,20,17,8,253,5,0,5,1,3,3,1,1120,0,6,1126,0,
220,526,22,10,5,63,0,1,3,2,3,3,2,640,0,12,652,0,
221,713,16,8,22,96,2,2,1,2,5,5,2,874,0,14,888,0,
222,367,568,11,12,129,2,0,0,6,5,4,4,1108,0,15,1123,0,
223,544,336,14,9,131,1,2,0,0,2,4,1,1044,0,9,1053,0,
224,318,414,9,4,52,0,1,1,5,2,5,7,818,0,6,824,0,
226,298,297,4,8,23,0,0,0,1,1,1,2,635,0,2,637,0,
227,300,401,5,4,15,0,1,1,1,2,3,1,734,0,11,745,0,
228,261,445,1,12,17,1,2,1,1,2,0,2,745,0,7,752,0,
229,665,191,11,11,80,1,3,0,1,6,1,2,972,0,6,978,0,
230,326,432,6,16,45,1,3,0,1,2,3,3,838,0,7,845,0,
231,338,312,6,8,32,1,0,0,2,2,5,3,709,0,10,719,0,
232,752,67,12,14,146,0,2,1,0,3,5,1,1003,0,3,1006,0,
233,606,32,8,11,136,0,2,0,1,0,2,1,799,0,8,807,0,
234,434,13,10,10,169,0,0,0,1,2,1,3,643,0,10,653,0,
235,404,666,4,8,44,0,1,0,1,2,0,2,1132,0,4,1136,0,
236,282,692,1,13,32,1,1,1,3,2,3,4,1035,0,8,1043,0,
237,222,495,5,6,77,0,0,1,3,4,3,7,823,0,5,828,0,
238,294,529,5,5,61,0,0,0,3,1,3,7,908,0,14,922,0,
239,245,515,1,5,21,0,1,1,1,2,8,3,803,0,13,816,0,
240,349,535,0,4,19,0,1,0,1,4,6,3,922,0,6,928,0,
241,211,607,6,9,48,0,0,1,3,1,3,10,899,0,16,915,0,
242,219,510,0,3,11,0,1,1,2,3,2,9,761,0,8,769,0,
243,164,385,2,3,31,0,1,0,0,2,3,5,596,0,7,603,0,
244,161,407,6,4,36,1,1,0,1,2,2,5,626,0,9,635,0,
245,236,497,1,5,55,1,2,2,3,5,6,10,823,0,11,834,0,
246,162,566,5,1,44,1,1,0,2,3,1,8,794,0,5,799,0,
247,435,29,12,6,107,1,2,0,0,1,5,3,601,0,3,604,0,
248,460,76,9,8,59,0,1,0,0,2,1,2,618,0,2,620,0,
249,386,555,5,7,28,0,2,0,0,2,2,4,991,0,6,997,0,
250,178,350,9,15,75,0,4,1,3,7,2,3,647,0,7,654,0,
251,140,390,8,5,83,0,1,1,2,1,3,2,636,0,3,639,0,
252,205,553,3,2,5,0,1,3,1,9,12,16,810,0,21,831,0,
253,186,347,4,4,69,0,0,0,2,3,1,7,623,0,13,636,0,
254,308,535,4,7,41,0,1,0,0,4,4,7,911,0,11,922,0,
255,167,393,0,15,24,0,0,1,3,4,3,11,621,0,14,635,0,
256,177,448,1,4,18,3,1,0,2,3,6,5,668,0,14,682,0,
257,270,385,1,8,27,0,0,0,4,5,4,3,707,0,16,723,0,
258,285,268,4,7,13,0,0,1,0,1,4,7,590,0,4,594,0,
259,240,422,1,6,22,1,1,0,0,1,0,6,700,0,5,705,0,
260,178,611,8,5,35,0,1,0,3,3,9,21,874,0,10,884,0,
261,321,362,8,20,42,2,0,0,1,9,2,0,767,0,7,774,0,
262,332,385,5,23,61,1,2,4,0,5,1,1,820,0,9,829,0,
263,252,285,1,33,50,1,1,0,0,1,0,1,625,0,3,628,0,
264,298,280,2,23,31,0,0,0,2,4,0,3,643,0,8,651,0,
265,220,380,1,15,21,0,2,0,5,3,4,6,657,0,13,670,0,
266,259,335,4,14,21,0,0,1,0,3,2,3,642,0,7,649,0,
267,210,405,3,43,109,0,1,0,0,0,1,1,773,0,27,800,0,
268,168,211,1,26,122,1,0,0,0,1,0,1,531,0,11,542,0,
269,57,127,0,13,48,0,2,0,0,0,1,1,249,0,11,260,0,
272,215,295,9,6,8,1,0,1,2,0,4,2,543,0,8,551,0,
273,235,400,5,9,13,0,2,1,5,4,5,5,684,0,9,693,0,
274,121,209,3,18,71,0,2,0,0,0,0,0,424,0,13,437,0,
275,107,222,1,18,53,0,1,0,0,0,0,0,402,0,13,415,0,
276,135,209,1,14,80,1,4,0,0,1,0,0,445,0,14,459,0,
277,146,281,1,16,104,0,0,1,0,2,0,0,551,0,18,569,0,
278,405,309,2,10,14,1,0,2,5,5,7,10,770,0,18,788,0,
279,266,349,3,6,19,2,4,0,3,8,8,6,674,0,13,687,0,
280,462,293,13,14,41,2,4,2,9,12,11,17,880,0,26,906,0,
1,353,293,1,30,86,0,0,0,0,1,1,0,765,0,21,786,0,
2,226,188,1,12,52,1,1,0,0,5,0,0,486,0,11,497,0,
3,291,221,1,20,75,0,1,0,0,1,1,1,612,0,15,627,0,
4,306,248,6,16,70,0,0,1,2,2,2,1,654,0,11,665,0,
5,380,205,5,27,50,0,0,1,1,3,1,2,675,0,21,696,0,
6,280,227,1,14,65,2,0,0,0,1,2,1,593,0,13,606,0,
7,53,33,1,5,51,0,0,0,0,0,0,0,143,0,4,147,0,
8,314,364,3,27,38,0,1,0,0,1,3,1,752,0,9,761,0,
9,188,607,3,32,34,0,4,0,0,0,0,0,868,0,18,886,0,
10,226,307,1,23,68,0,2,1,0,0,1,1,630,0,17,647,0,
11,313,198,0,12,34,1,1,0,0,2,1,3,565,0,9,574,0,
12,174,166,1,11,23,0,1,3,0,1,1,1,382,0,10,392,0,
13,321,278,0,25,77,3,2,1,1,2,0,0,710,0,20,730,0,
14,184,197,1,19,73,2,0,0,1,1,0,0,478,0,16,494,0,
15,341,278,3,15,92,1,4,0,0,0,1,1,736,0,24,760,0,
16,344,446,4,18,71,1,0,0,1,3,1,2,891,0,13,904,0,
17,218,198,1,25,43,0,0,0,0,0,1,0,486,0,17,503,0,
18,185,207,1,24,72,2,0,0,1,1,0,1,494,0,15,509,0,
19,259,252,1,36,74,1,2,1,1,0,0,0,627,0,17,644,0,
20,258,238,2,26,67,0,1,0,2,3,1,1,599,0,13,612,0,
21,155,313,1,8,42,1,0,0,0,1,1,2,524,0,12,536,0,
22,107,334,0,12,19,0,1,0,0,0,0,2,475,0,5,480,0,
23,76,364,0,12,16,0,0,0,0,0,0,1,469,0,8,477,0,
24,91,492,0,8,2,0,1,0,0,0,0,0,594,0,4,598,0,
25,60,616,0,12,1,1,0,0,1,0,0,0,691,0,8,699,0,
26,248,268,5,5,47,0,0,1,3,2,0,7,586,0,2,588,0,
27,163,370,3,15,13,1,0,0,0,0,0,1,566,0,7,573,0,
28,105,373,1,9,17,1,3,0,1,0,0,0,510,0,11,521,0,
29,130,226,0,10,30,1,0,0,1,0,0,1,399,0,14,413,0,
30,135,342,1,19,16,0,0,0,0,0,0,0,513,0,5,518,0,
31,186,289,0,20,49,1,0,0,1,0,0,2,548,0,20,568,0,
32,172,330,0,22,41,0,0,0,0,0,0,0,565,0,17,582,0,
33,154,462,0,15,16,0,1,0,0,1,1,1,651,0,14,665,0,
34,186,350,2,19,44,1,0,0,0,1,1,0,604,0,12,616,0,
35,139,232,0,12,21,0,1,0,0,0,1,0,406,0,10,416,0,
36,106,314,1,14,37,0,0,0,1,0,0,0,473,0,7,480,0,
37,128,234,1,12,25,0,0,0,0,0,1,1,402,0,10,412,0,
38,142,269,1,12,38,0,1,0,0,1,0,0,464,0,4,468,0,
39,142,344,1,10,26,0,0,0,0,0,0,1,524,0,15,539,0,
40,171,240,4,19,28,4,0,0,0,1,0,0,467,0,9,476,0,
41,117,351,1,11,7,0,2,0,0,0,0,0,489,0,13,502,0,
42,83,373,0,12,18,0,0,0,1,0,0,0,487,0,7,494,0,
43,193,277,1,10,22,0,0,0,0,1,0,0,504,0,3,507,0,
44,197,202,0,21,33,0,0,0,0,0,1,1,455,0,9,464,0,
45,87,264,1,14,18,0,0,0,0,0,0,0,384,0,10,394,0,
46,110,192,0,15,17,2,3,0,0,0,0,0,339,0,9,348,0,
47,246,298,1,25,80,0,1,0,0,0,0,2,653,0,12,665,0,
48,126,488,3,14,16,1,0,0,1,1,0,0,650,0,12,662,0,
49,252,273,0,12,30,0,2,0,1,0,0,0,570,0,13,583,0,
50,179,434,1,16,29,1,2,0,0,1,0,0,663,0,16,679,0,
51,204,364,0,20,31,1,0,0,0,0,1,0,621,0,19,640,0,
52,216,255,2,13,49,0,0,3,0,1,0,0,539,0,14,553,0,
53,96,344,1,15,24,0,0,0,0,0,0,0,480,0,13,493,0,
54,173,231,0,13,29,0,0,0,0,1,0,2,449,0,8,457,0,
55,106,200,1,8,25,0,0,0,0,0,0,0,340,0,12,352,0,
56,134,182,0,6,13,0,0,0,0,0,0,0,335,0,7,342,0,
57,339,259,2,18,24,0,0,0,0,1,0,0,643,0,6,649,0,
58,263,285,7,12,60,1,0,1,0,2,0,3,634,0,9,643,0,
59,291,263,1,7,155,1,2,1,1,2,0,1,725,0,11,736,0,
60,170,132,1,21,51,0,1,0,0,1,1,0,378,0,20,398,0,
61,178,179,1,24,27,0,0,1,1,1,1,0,413,0,15,428,0,
62,246,164,1,20,83,0,0,0,0,0,0,0,514,0,18,532,0,
63,238,258,3,12,62,1,0,0,2,5,2,2,585,0,1,586,0,
64,266,219,6,15,55,0,0,0,1,1,2,0,565,0,5,570,0,
65,317,301,8,14,68,1,1,0,2,0,5,1,718,0,8,726,0,
66,263,215,5,2,43,1,2,0,3,0,0,3,537,0,3,540,0,
67,127,260,2,6,27,0,0,0,0,0,0,1,423,0,2,425,0,
68,190,340,0,24,42,0,1,0,2,0,0,4,603,0,10,613,0,
69,243,195,1,3,70,2,0,0,2,1,2,0,519,0,4,523,0,
70,255,220,5,1,83,0,0,0,1,2,1,1,569,0,8,577,0,
71,586,220,0,10,41,0,0,0,0,1,2,2,862,0,7,869,0,
72,275,228,3,4,56,0,0,1,1,3,1,4,576,0,17,593,0,
73,286,269,6,5,70,0,1,0,1,1,0,1,640,0,2,642,0,
74,460,219,1,22,42,2,0,0,0,2,3,4,755,0,17,772,0,
75,445,259,3,14,27,0,0,0,2,2,3,2,757,0,8,765,0,
76,472,210,6,4,65,0,1,0,3,2,2,3,768,0,17,785,0,
77,126,100,0,9,94,0,0,0,0,1,0,1,331,0,15,346,0,
78,338,223,7,22,144,0,0,0,0,5,1,2,742,0,18,760,0,
79,267,453,1,27,83,3,0,1,1,0,1,3,840,0,10,850,0,
80,234,175,5,11,65,0,1,0,0,0,1,0,492,0,12,504,0,
81,227,197,3,26,71,1,0,1,0,7,1,0,534,0,6,540,0,
82,145,153,1,19,105,0,0,1,0,1,0,0,425,0,4,429,0,
83,205,144,3,13,163,2,0,1,2,0,3,0,536,0,9,545,0,
84,242,249,2,18,137,0,1,1,3,1,1,0,655,0,20,675,0,
85,153,167,3,9,53,0,0,0,1,0,0,1,387,0,5,392,0,
86,163,143,3,13,60,0,1,1,0,0,0,1,385,0,7,392,0,
87,146,221,8,15,204,3,1,5,9,4,5,9,630,0,12,642,0,
88,194,367,2,5,169,1,0,1,0,3,1,0,743,0,8,751,0,
89,215,250,4,22,64,0,0,1,1,0,0,1,558,0,10,568,0,
90,222,274,2,29,89,0,1,1,0,2,0,0,620,0,14,634,0,
91,206,174,4,10,75,0,0,0,1,1,0,1,472,0,19,491,0,
92,195,140,0,19,69,0,0,0,0,0,0,0,423,0,16,439,0,
93,254,232,3,9,55,0,0,0,1,0,3,2,559,0,8,567,0,
94,274,388,1,7,36,1,0,0,0,1,1,1,710,0,6,716,0,
95,225,200,1,12,27,0,1,0,1,0,0,1,468,0,3,471,0,
96,262,227,0,13,37,0,0,0,0,0,0,0,539,0,7,546,0,
97,157,394,0,12,22,0,0,0,1,1,1,0,588,0,13,601,0,
98,234,226,1,13,53,0,0,0,1,1,1,0,530,0,3,533,0,
99,183,287,0,9,20,0,0,1,0,1,1,1,503,0,7,510,0,
100,149,319,0,6,15,0,0,0,1,0,0,0,490,0,5,495,0,
101,170,193,0,8,34,0,0,0,0,0,0,0,405,0,10,415,0,
102,195,192,1,9,21,0,0,0,0,0,0,0,418,0,11,429,0,
103,351,327,2,13,33,1,1,1,0,1,1,0,731,0,12,743,0,
104,232,343,3,16,52,1,0,1,2,0,3,3,656,0,10,666,0,
105,110,406,4,8,22,0,0,1,1,3,2,7,564,0,6,570,0,
106,268,332,0,12,22,0,0,1,0,0,0,0,635,0,10,645,0,
107,135,422,2,8,27,1,0,1,0,0,0,1,597,0,7,604,0,
108,419,252,4,32,53,0,0,2,2,1,2,12,779,0,19,798,0,
109,292,354,8,33,29,0,0,2,3,8,1,9,739,0,12,751,0,
110,686,137,7,58,27,1,2,1,0,2,2,6,929,0,21,950,0,
111,223,357,5,3,36,0,0,0,0,1,2,5,632,0,5,637,0,
112,118,277,0,14,15,0,0,0,1,0,0,1,426,0,9,435,0,
114,385,414,3,22,43,1,1,0,1,1,4,11,886,0,16,902,0,
115,286,299,7,9,112,1,0,0,1,0,0,2,717,0,6,723,0,
116,323,243,6,2,75,0,0,0,3,2,2,1,657,0,7,664,0,
117,283,330,14,9,82,2,1,1,6,7,5,6,746,0,18,764,0,
118,216,393,6,12,61,1,0,0,1,4,1,4,699,0,12,711,0,
119,406,287,6,4,63,2,0,0,1,4,1,2,776,0,17,793,0,
120,257,270,3,3,91,0,0,1,2,1,1,9,638,0,11,649,0,
121,241,422,6,13,41,3,0,2,3,0,3,2,736,0,9,745,0,
122,184,432,2,6,11,1,0,2,0,0,1,2,641,0,8,649,0,
123,383,411,3,8,127,0,3,2,1,2,2,0,942,0,6,948,0,
124,309,307,1,15,55,0,0,2,2,2,1,3,697,0,5,702,0,
125,297,285,6,5,42,0,0,0,1,2,1,4,643,0,5,648,0,
126,131,311,2,20,45,0,0,0,0,1,2,1,513,0,22,535,0,
127,152,247,1,19,30,0,0,1,1,0,2,1,454,0,16,470,0,
128,118,222,1,13,76,0,1,0,0,0,1,1,433,0,19,452,0,
129,104,206,2,14,56,1,0,0,0,0,0,0,383,0,10,393,0,
130,99,273,1,12,41,1,0,0,0,1,0,1,429,0,12,441,0,
131,148,217,2,13,38,2,4,1,1,0,0,0,426,0,13,439,0,
132,174,346,3,25,58,0,0,0,0,0,1,3,610,0,22,632,0,
133,172,276,0,26,43,0,0,0,0,0,0,0,517,0,14,531,0,
134,221,350,1,27,57,2,1,1,0,0,0,2,662,0,27,689,0,
135,160,332,1,28,52,0,2,0,0,1,1,0,577,0,7,584,0,
136,166,324,1,14,37,0,0,1,0,0,0,1,544,0,11,555,0,
137,90,132,1,7,85,0,1,0,0,0,1,0,317,0,2,319,0,
138,174,246,0,16,103,0,1,0,1,2,0,0,543,0,15,558,0,
139,191,293,2,10,100,2,2,0,0,1,0,0,601,0,10,611,0,
140,120,417,1,21,22,0,0,0,0,0,1,0,582,0,14,596,0,
141,157,348,0,16,35,1,1,2,0,0,2,0,562,0,17,579,0,
142,194,259,1,34,85,1,2,2,0,0,1,2,581,0,17,598,0,
143,112,158,0,10,30,0,8,0,0,0,1,0,319,0,16,335,0,
144,160,381,0,20,36,1,0,0,0,1,0,0,599,0,17,616,0,
145,73,261,1,14,24,0,1,0,0,0,0,1,375,0,31,406,0,
146,74,263,1,11,9,0,8,0,0,1,0,1,368,0,9,377,0,
147,103,399,1,10,23,0,0,1,0,0,0,0,537,0,9,546,0,
148,110,290,1,16,25,0,2,0,1,0,0,2,447,0,13,460,0,
149,97,299,0,18,16,0,0,0,0,0,1,1,432,0,10,442,0,
150,165,463,4,24,24,0,0,0,0,0,0,0,680,0,28,708,0,
151,50,50,0,9,5,0,2,0,0,0,0,0,116,0,1,117,0,
152,163,333,0,28,18,0,1,0,2,3,0,1,549,0,16,565,0,
153,169,262,1,22,17,0,1,1,1,0,0,1,475,0,17,492,0,
154,113,90,0,17,22,1,0,0,0,1,0,0,244,0,3,247,0,
155,143,397,0,21,18,0,0,0,1,0,1,2,583,0,15,598,0,
156,167,423,1,26,15,1,3,0,0,1,0,0,637,0,14,651,0,
157,149,348,0,17,45,0,0,0,1,0,0,3,563,0,21,584,0,
158,177,267,0,28,66,1,0,0,0,0,0,2,541,0,26,567,0,
159,162,230,0,21,56,0,1,0,0,0,0,2,472,0,19,491,0,
160,155,252,0,19,45,0,1,0,0,2,1,1,476,0,23,499,0,
161,107,169,0,16,62,1,0,0,0,0,1,0,356,0,10,366,0,
162,160,279,3,24,60,1,2,1,0,0,1,2,533,0,20,553,0,
163,176,365,2,20,24,0,1,0,0,0,0,0,588,0,20,608,0,
164,354,338,6,8,47,1,1,2,1,0,1,1,760,0,7,767,0,
165,262,310,2,38,62,0,0,0,0,0,1,1,676,0,17,693,0,
166,179,336,2,26,35,0,0,0,0,1,0,0,579,0,22,601,0,
167,164,375,1,36,34,1,1,1,0,1,0,1,615,0,20,635,0,
168,238,272,8,11,32,0,1,2,0,6,2,6,578,0,8,586,0,
169,229,321,1,7,46,0,1,0,0,1,0,1,607,0,7,614,0,
170,156,332,1,21,26,1,1,2,1,1,0,0,542,0,12,554,0,
171,127,256,0,23,20,0,0,0,0,1,0,1,428,0,16,444,0,
172,192,185,2,17,62,0,1,0,0,2,0,0,461,0,10,471,0,
173,385,491,5,8,109,1,3,1,2,7,8,4,1024,0,13,1037,0,
174,204,418,3,25,25,1,0,1,0,0,0,0,677,0,10,687,0,
175,226,190,1,16,97,0,2,1,1,1,1,0,536,0,18,554,0,
176,72,61,4,8,16,0,1,0,0,0,0,0,162,0,2,164,0,
177,188,184,2,24,95,0,0,0,0,2,0,1,496,0,12,508,0,
178,136,285,0,17,9,0,0,0,1,0,1,0,449,0,13,462,0,
179,138,263,1,15,13,0,0,0,0,1,0,1,432,0,11,443,0,
180,185,304,3,12,95,3,4,0,0,1,2,0,609,0,22,631,0,
181,154,197,4,18,58,1,1,0,0,0,0,1,434,0,16,450,0,
182,123,167,0,15,73,0,3,0,0,1,1,0,383,0,22,405,0,
183,110,162,2,15,72,0,2,0,1,1,0,0,365,0,16,381,0,
184,271,226,0,18,112,0,1,2,1,0,0,0,631,0,19,650,0,
185,264,309,1,26,183,0,1,0,0,0,0,0,784,0,31,815,0,
186,255,298,0,22,154,0,4,1,0,0,0,0,734,0,30,764,0,
187,216,279,0,17,128,1,2,0,0,1,0,0,644,0,26,670,0,
188,214,371,0,25,62,0,3,0,1,1,0,0,677,0,23,700,0,
189,113,244,1,20,58,0,0,0,0,0,0,1,437,0,10,447,0,
190,121,181,2,18,69,0,1,0,1,2,0,0,395,0,11,406,0,
191,166,235,1,23,106,0,2,0,1,2,0,0,536,0,18,554,0,
192,176,297,2,16,102,0,0,0,0,1,0,1,595,0,23,618,0,
193,122,141,1,14,41,0,1,0,0,0,0,0,320,0,9,329,0,
194,151,393,1,20,41,0,1,0,0,1,0,0,608,0,16,624,0,
195,122,418,0,19,37,0,2,1,0,0,1,2,602,0,8,610,0,
196,114,186,3,16,56,1,0,0,0,0,0,0,376,0,11,387,0,
197,118,200,0,10,51,0,2,0,0,0,0,0,381,0,11,392,0,
198,211,321,1,18,102,2,10,0,0,1,0,2,668,0,13,681,0,
199,109,235,3,12,79,1,0,0,0,2,1,0,442,0,15,457,0,
200,108,234,1,18,41,0,1,0,1,1,1,0,406,0,16,422,0,
201,34,44,2,5,12,0,1,0,0,1,0,0,99,0,0,99,0,
202,282,405,3,16,22,2,0,1,5,1,2,3,742,0,12,754,0,
203,446,644,4,14,25,1,1,3,2,3,4,2,1149,0,13,1162,0,
204,267,359,7,16,41,0,1,0,1,5,2,2,701,0,13,714,0,
205,192,285,5,10,28,2,1,2,0,2,1,5,533,0,3,536,0,
206,313,359,3,5,10,0,0,0,1,1,3,3,698,0,2,700,0,
207,235,409,3,5,41,0,0,1,2,9,1,4,710,0,6,716,0,
208,419,374,4,14,18,1,0,1,0,3,2,3,839,0,8,847,0,
209,383,464,6,12,27,5,2,2,4,12,9,5,931,0,7,938,0,
210,267,400,6,12,52,0,1,0,3,3,6,3,753,0,12,765,0,
211,296,272,4,9,24,0,0,0,0,1,2,1,609,0,8,617,0,
212,305,327,3,12,22,0,0,1,2,2,3,1,678,0,5,683,0,
213,95,236,3,17,52,0,0,0,0,3,0,1,407,0,12,419,0,
214,106,157,2,18,60,0,0,1,0,0,1,0,345,0,17,362,0,
215,77,289,1,14,31,0,2,0,0,1,0,1,416,0,9,425,0,
216,84,240,2,9,36,0,1,1,0,1,0,0,374,0,9,383,0,
217,115,342,3,17,61,1,0,0,0,0,0,0,539,0,14,553,0,
218,111,291,1,13,100,0,0,1,1,0,0,3,521,0,12,533,0,
219,113,269,2,10,43,0,0,1,0,3,2,0,443,0,9,452,0,
220,111,206,1,29,53,0,5,0,0,0,0,0,405,0,14,419,0,
221,111,190,1,28,118,1,1,0,1,3,0,0,454,0,20,474,0,
222,222,436,1,28,57,1,1,0,0,3,0,1,750,0,20,770,0,
223,140,124,4,8,25,0,0,1,0,0,0,2,304,0,7,311,0,
224,144,169,0,12,92,0,0,1,0,2,0,0,420,0,21,441,0,
225,107,218,0,26,100,0,0,0,1,0,0,0,452,0,12,464,0,
226,106,203,0,19,137,1,2,0,0,2,0,2,472,0,17,489,0,
227,183,307,3,32,131,0,1,0,0,0,0,2,659,0,28,687,0,
228,343,472,5,16,35,2,3,1,2,1,5,10,895,0,30,925,0,
229,350,461,8,6,65,0,1,1,1,2,3,3,901,0,15,916,0,
230,360,385,5,10,41,4,4,0,4,7,4,9,833,0,26,859,0,
231,376,386,0,9,41,2,1,0,1,2,1,4,823,0,13,836,0,
232,330,356,0,3,8,0,0,1,1,2,3,5,709,0,19,728,0,
233,486,342,3,3,11,1,1,0,2,1,3,5,858,0,28,886,0,
234,650,413,2,9,44,1,1,2,2,3,3,8,1138,0,21,1159,0,
235,149,179,3,13,36,0,0,0,1,0,0,2,383,0,15,398,0,
236,130,162,1,11,30,0,0,0,0,0,0,0,334,0,20,354,0,
237,116,128,1,9,62,3,1,0,0,1,0,0,321,0,5,326,0,
238,210,309,1,18,52,1,0,0,0,0,0,0,591,0,16,607,0,
239,160,113,0,14,63,1,1,1,0,0,0,0,353,0,15,368,0,
240,99,143,0,10,38,1,0,0,0,0,0,0,291,0,14,305,0,
241,161,141,3,15,59,0,0,1,0,0,0,0,380,0,19,399,0,
242,68,83,0,11,29,0,1,0,0,2,0,0,194,0,4,198,0,
243,130,288,0,16,50,0,2,0,0,0,0,0,486,0,15,501,0,
244,151,216,3,14,55,0,1,0,1,1,0,0,442,0,20,462,0,
245,91,60,0,9,7,0,0,0,0,0,1,0,168,0,3,171,0,
246,177,261,0,34,97,2,0,1,0,2,1,2,577,0,8,585,0,
247,209,239,2,34,130,0,3,0,1,1,0,0,619,0,21,640,0,
248,121,367,0,19,12,0,5,0,0,0,0,0,524,0,11,535,0,
249,125,216,0,18,53,0,3,0,0,0,0,1,416,0,8,424,0,
250,245,189,0,41,10,0,0,0,0,1,0,1,487,0,11,498,0,
251,148,234,1,24,61,1,1,1,0,0,0,1,472,0,7,479,0,
252,43,119,2,9,46,1,0,0,0,0,1,0,221,0,4,225,0,
253,198,180,5,18,24,1,0,0,0,3,0,0,429,0,5,434,0,
254,49,93,0,6,21,0,0,0,0,1,0,0,170,0,3,173,0,
255,62,119,0,8,21,0,0,0,0,1,0,0,211,0,9,220,0,
256,204,148,3,7,119,1,0,1,5,1,0,2,491,0,8,499,0,
257,208,175,6,11,77,1,0,1,1,1,1,1,483,0,6,489,0,
258,415,311,11,16,143,1,1,1,5,5,3,1,913,0,21,934,0,
259,235,274,8,8,57,2,3,2,3,1,2,2,597,0,9,606,0,
260,206,262,5,12,52,1,0,0,5,4,3,11,561,0,13,574,0,
261,227,251,6,11,63,0,0,1,0,2,1,4,566,0,8,574,0,
262,222,184,10,9,77,1,1,0,0,4,3,2,513,0,9,522,0,
263,327,344,4,18,38,1,0,2,3,5,3,6,751,0,14,765,0,
264,322,448,1,16,36,0,0,3,0,3,2,1,832,0,9,841,0,
265,299,343,7,9,23,0,1,3,4,10,12,10,721,0,20,741,0,
266,284,380,4,7,28,0,0,1,3,1,5,3,716,0,11,727,0,
267,271,332,6,12,35,1,1,3,5,5,7,12,690,0,25,715,0,
268,246,351,1,11,25,0,1,2,4,3,4,6,654,0,4,658,0,
269,364,409,9,21,55,1,2,3,6,9,7,11,897,0,21,918,0,
270,385,441,0,17,54,1,1,0,2,1,0,5,907,0,6,913,0,
271,313,373,3,14,32,2,0,1,1,4,2,5,750,0,15,765,0,
272,347,386,1,4,23,0,3,3,3,7,5,4,786,0,14,800,0,
273,232,194,4,6,91,1,0,2,4,0,4,5,543,0,27,570,0,
274,570,349,5,9,56,1,3,3,3,5,8,14,1026,0,49,1075,0,
275,478,425,4,25,12,1,4,2,3,9,6,15,984,0,34,1018,0,
276,422,497,7,13,20,1,1,4,0,4,3,7,979,0,9,988,0,
277,384,466,14,12,66,1,4,1,6,5,4,9,972,0,19,991,0,
278,244,112,2,0,17,1,0,1,0,2,3,1,383,0,6,389,0,
1,318,444,6,13,11,0,0,0,0,0,1,5,798,0,8,806,0,
2,481,406,6,14,91,3,2,0,3,3,9,3,1021,0,11,1032,0,
3,268,451,0,31,14,1,0,0,0,2,4,3,774,0,14,788,0,
4,720,66,9,39,196,1,0,4,4,1,6,2,1048,0,9,1057,0,
5,205,314,7,7,51,2,0,0,1,0,1,0,588,0,4,592,0,
6,234,303,4,0,35,0,0,1,1,1,0,3,582,0,4,586,0,
7,283,475,8,3,74,1,0,1,1,2,1,4,853,0,10,863,0,
8,333,478,4,5,74,0,0,0,0,0,2,3,899,0,3,902,0,
9,194,333,3,0,52,0,1,0,0,0,3,1,587,0,5,592,0,
10,208,292,7,7,21,0,0,1,1,1,1,2,541,0,5,546,0,
11,308,359,6,10,77,0,2,0,2,2,2,5,773,0,15,788,0,
12,314,231,1,10,39,2,2,0,0,1,2,0,602,0,8,610,0,
13,403,18,12,130,42,0,0,1,1,1,1,2,611,0,9,620,0,
14,429,8,3,3,75,0,0,0,3,2,3,2,528,0,4,532,0,
15,481,22,8,158,95,2,0,2,4,3,1,2,778,0,4,782,0,
16,448,62,6,109,98,1,0,2,0,1,3,3,733,0,8,741,0,
17,418,455,5,19,52,1,3,0,0,0,4,3,960,0,6,966,0,
18,371,185,1,18,24,1,0,0,0,0,2,1,603,0,3,606,0,
19,410,196,11,29,183,1,1,3,0,4,2,1,841,0,10,851,0,
20,334,72,9,17,125,0,1,1,2,0,0,2,563,0,5,568,0,
21,305,295,5,3,22,0,0,0,0,1,3,3,637,0,2,639,0,
22,653,15,34,17,346,2,3,1,10,0,8,5,1094,0,19,1113,0,
23,533,78,8,19,123,1,0,1,1,0,3,4,771,0,10,781,0,
24,232,316,5,5,14,1,2,0,0,1,1,4,581,0,5,586,0,
25,341,9,9,29,81,0,0,0,0,0,0,0,469,0,5,474,0,
26,651,58,11,88,144,0,0,1,1,0,0,1,955,0,8,963,0,
27,557,49,3,8,55,0,0,0,0,0,2,0,674,0,5,679,0,
28,561,61,6,10,52,1,0,0,0,0,2,0,693,0,2,695,0,
29,484,198,5,23,75,0,1,1,1,1,4,3,796,0,9,805,0,
30,361,358,5,6,17,2,0,1,1,0,2,3,756,0,12,768,0,
31,472,288,2,60,31,0,0,0,2,1,3,2,861,0,10,871,0,
32,483,12,8,5,135,0,0,0,0,0,0,2,645,0,4,649,0,
33,668,9,7,15,96,1,0,2,0,2,7,2,809,0,10,819,0,
34,875,4,2,9,32,1,0,0,2,0,3,1,929,0,5,934,0,
35,483,7,4,29,58,0,0,0,0,0,2,1,584,0,6,590,0,
36,590,12,5,12,43,1,0,0,0,0,3,1,667,0,5,672,0,
37,560,156,5,321,37,0,0,1,0,1,2,0,1083,0,3,1086,0,
38,509,23,6,34,49,0,0,0,0,0,3,1,625,0,2,627,0,
39,367,6,2,68,72,0,2,1,0,2,2,0,522,0,9,531,0,
40,367,590,7,2,7,1,1,2,1,3,3,8,992,0,8,1000,0,
41,329,670,16,2,12,0,1,0,1,2,6,6,1045,0,8,1053,0,
42,183,694,18,6,7,1,0,0,3,0,2,3,917,0,19,936,0,
43,334,302,1,17,24,1,0,0,1,0,2,1,683,0,5,688,0,
44,635,145,5,51,69,2,1,2,0,2,1,1,914,0,5,919,0,
45,471,75,2,14,115,0,0,1,2,0,2,2,684,0,9,693,0,
46,527,309,6,9,34,2,0,1,2,1,3,3,897,0,12,909,0,
47,208,634,18,4,8,0,0,1,2,0,1,2,878,0,7,885,0,
48,243,805,11,3,17,0,1,0,2,0,7,10,1099,0,9,1108,0,
49,160,183,9,4,136,1,0,0,1,0,1,1,496,0,2,498,0,
50,293,165,7,1,212,0,2,0,2,2,0,5,689,0,6,695,0,
51,315,165,0,19,33,0,2,0,0,0,2,5,541,0,6,547,0,
52,598,106,18,15,80,0,0,0,0,0,4,4,825,0,11,836,0,
53,283,463,0,2,20,1,1,0,4,2,2,1,779,0,9,788,0,
54,207,198,2,2,3,1,0,0,0,1,4,0,418,0,5,423,0,
55,684,8,2,25,63,1,0,1,0,1,3,2,790,0,12,802,0,
56,402,187,4,11,16,0,1,0,0,0,3,0,624,0,4,628,0,
57,515,14,3,7,58,0,0,0,0,0,1,4,602,0,7,609,0,
58,447,151,8,7,71,0,0,2,0,1,3,2,692,0,11,703,0,
59,242,237,1,1,32,1,0,0,0,1,4,0,519,0,7,526,0,
60,318,343,6,5,62,1,0,3,4,5,4,5,756,0,9,765,0,
61,309,436,8,5,48,0,3,0,0,1,5,5,820,0,17,837,0,
62,361,269,4,8,20,1,1,1,4,0,7,2,678,0,5,683,0,
63,257,205,1,6,37,0,2,0,1,2,1,1,513,0,1,514,0,
64,503,349,8,9,61,1,0,0,0,1,3,3,938,0,8,946,0,
65,326,393,5,18,62,2,2,2,1,2,1,1,815,0,14,829,0,
66,281,343,9,23,64,2,0,0,0,1,0,0,723,0,14,737,0,
67,292,434,9,9,54,1,0,0,2,2,0,1,804,0,10,814,0,
68,260,364,6,14,52,0,0,0,2,4,5,1,708,0,10,718,0,
69,307,357,6,5,68,1,2,1,2,4,1,0,754,0,3,757,0,
70,386,311,7,13,84,0,0,1,1,3,3,4,813,0,10,823,0,
71,405,314,13,8,23,0,1,2,4,2,4,2,778,0,15,793,0,
72,652,207,9,15,78,3,1,6,3,1,3,3,981,0,5,986,0,
73,436,568,15,15,69,3,0,0,0,3,2,4,1115,0,12,1127,0,
74,305,359,7,8,56,0,1,1,1,3,2,1,744,0,4,748,0,
75,242,350,3,3,64,0,0,1,1,3,1,2,670,0,7,677,0,
76,376,406,12,9,42,0,2,3,0,5,7,1,863,0,17,880,0,
77,289,379,8,6,86,1,0,0,1,3,1,4,778,0,9,787,0,
78,492,525,8,16,114,3,3,1,2,2,3,4,1173,0,5,1178,0,
79,351,602,22,7,67,1,1,2,1,5,7,7,1073,0,17,1090,0,
80,291,387,7,3,51,2,1,1,0,4,9,8,764,0,10,774,0,
81,350,560,7,6,95,2,0,2,0,2,4,2,1030,0,3,1033,0,
82,159,147,3,3,50,0,1,0,0,0,0,1,364,0,11,375,0,
83,497,396,14,10,117,0,1,1,0,3,1,3,1043,0,10,1053,0,
84,233,212,4,7,109,0,0,1,3,1,2,0,572,0,2,574,0,
85,286,362,3,10,70,0,0,1,1,1,3,6,743,0,8,751,0,
86,511,342,6,16,128,1,0,0,2,2,3,2,1013,0,8,1021,0,
87,251,190,2,7,84,1,1,0,0,0,1,2,539,0,5,544,0,
88,300,242,1,7,53,0,0,0,0,0,1,2,606,0,9,615,0,
89,272,305,3,10,126,0,0,1,1,0,1,1,720,0,7,727,0,
90,148,207,7,4,135,1,0,2,6,3,1,2,516,0,10,526,0,
91,208,290,5,19,77,0,0,2,1,0,1,2,605,0,6,611,0,
92,259,241,6,16,66,0,0,2,0,0,2,1,593,0,2,595,0,
93,285,306,6,40,144,0,0,1,0,1,2,2,787,0,21,808,0,
94,419,325,8,10,171,4,3,1,0,2,1,1,945,0,15,960,0,
95,344,282,1,25,111,0,1,0,0,1,0,1,766,0,7,773,0,
96,320,307,3,10,77,0,1,0,0,1,1,1,721,0,10,731,0,
97,353,473,7,14,98,1,0,0,0,2,1,0,949,0,19,968,0,
98,416,562,22,26,113,1,2,0,2,2,2,1,1149,0,4,1153,0,
99,289,256,6,14,138,1,0,0,1,1,3,1,710,0,9,719,0,
100,238,181,4,23,35,0,0,2,0,3,2,1,489,0,9,498,0,
101,244,285,5,22,100,1,1,0,0,1,0,2,661,0,8,669,0,
102,224,216,3,12,206,1,0,1,0,2,1,1,667,0,12,679,0,
103,0,0,0,0,0,0,0,0,0,0,0,0,0,0,0,0,0,
104,358,234,11,14,202,3,1,0,1,1,1,0,826,0,18,844,0,
105,352,289,5,17,271,2,0,0,1,2,3,2,944,0,18,962,0,
106,458,245,5,19,119,0,1,1,2,0,2,1,853,0,14,867,0,
107,483,268,4,21,170,0,0,1,2,0,0,0,949,0,16,965,0,
108,277,211,3,17,89,0,0,0,1,2,1,2,603,0,13,616,0,
109,261,147,3,11,70,0,0,0,0,0,0,2,494,0,3,497,0,
110,398,252,9,5,119,0,0,0,1,1,0,1,786,0,11,797,0,
111,329,231,2,27,82,0,0,0,1,0,0,1,673,0,9,682,0,
112,289,157,2,16,94,0,0,0,3,1,1,0,563,0,20,583,0,
113,273,124,1,15,56,2,1,1,0,0,0,1,474,0,5,479,0,
114,335,132,0,15,91,0,1,0,0,1,3,1,579,0,8,587,0,
115,332,205,3,34,121,1,0,0,0,2,0,0,698,0,13,711,0,
116,284,154,6,7,13,0,2,1,0,2,1,3,473,0,12,485,0,
117,255,154,2,22,64,0,2,0,1,0,0,0,500,0,12,512,0,
118,294,199,2,13,59,1,0,1,0,0,1,0,570,0,8,578,0,
119,158,135,4,14,72,0,2,0,4,1,1,0,391,0,12,403,0,
120,313,306,5,23,170,0,1,0,1,1,1,0,821,0,7,828,0,
121,261,168,1,5,95,0,2,0,1,2,0,3,538,0,5,543,0,
122,255,209,1,19,134,1,1,0,0,2,1,1,624,0,11,635,0,
123,273,283,2,33,155,0,1,0,1,1,1,3,753,0,18,771,0,
124,309,347,7,18,115,2,0,0,0,2,3,4,807,0,9,816,0,
125,275,170,6,11,68,0,0,0,1,0,2,1,534,0,6,540,0,
126,479,340,4,15,128,1,0,0,0,0,1,3,971,0,15,986,0,
127,208,237,4,18,110,2,0,0,2,1,3,4,589,0,12,601,0,
128,337,361,8,12,110,1,2,5,1,0,1,3,841,0,18,859,0,
129,219,217,4,13,57,0,0,0,0,1,0,2,513,0,9,522,0,
130,326,171,6,17,97,0,0,0,0,0,0,0,617,0,10,627,0,
131,470,313,10,14,87,1,2,1,2,4,3,1,908,0,10,918,0,
132,276,160,7,16,108,1,0,0,1,0,0,1,570,0,6,576,0,
133,401,398,8,11,148,3,0,0,1,1,1,2,974,0,9,983,0,
134,321,294,4,19,175,1,0,0,1,0,0,0,815,0,14,829,0,
135,167,137,2,5,89,0,0,0,2,0,0,0,402,0,13,415,0,
136,511,334,6,24,91,0,1,1,3,1,3,1,976,0,27,1003,0,
137,443,294,8,28,161,0,0,0,0,0,1,2,937,0,14,951,0,
138,209,209,1,14,92,0,0,0,1,0,0,0,526,0,6,532,0,
139,159,157,0,7,62,0,1,0,1,0,0,3,390,0,8,398,0,
140,290,304,4,24,56,0,0,0,0,0,1,3,682,0,12,694,0,
141,477,311,3,27,203,1,3,0,0,0,0,0,1025,0,13,1038,0,
142,333,283,4,13,107,0,0,0,0,1,0,2,743,0,7,750,0,
143,153,160,1,8,80,2,0,0,0,0,0,2,406,0,8,414,0,
144,254,296,3,8,135,0,2,0,1,1,0,3,703,0,22,725,0,
145,270,278,6,12,156,0,2,0,0,1,0,1,726,0,23,749,0,
146,241,232,3,10,153,0,2,0,1,1,0,0,643,0,21,664,0,
147,176,196,3,7,107,0,0,0,0,2,0,0,491,0,6,497,0,
148,234,210,2,14,111,0,1,0,1,1,0,0,574,0,15,589,0,
149,231,206,1,10,114,0,1,0,0,1,0,0,564,0,11,575,0,
150,332,477,10,9,205,0,1,3,4,2,1,5,1049,0,11,1060,0,
151,341,551,9,13,261,2,2,0,2,2,8,4,1195,0,11,1206,0,
152,367,245,3,15,61,0,0,0,0,0,0,1,692,0,9,701,0,
153,326,339,2,6,124,1,0,1,1,0,5,,811,0,4,815,0,
154,172,214,1,11,46,0,0,0,0,0,0,1,445,0,5,450,0,
155,529,153,3,18,134,1,1,0,2,1,3,1,846,0,10,856,0,
156,241,357,5,16,131,1,1,2,4,4,1,1,764,0,6,770,0,
157,459,232,1,9,101,1,1,0,1,1,1,,809,0,27,836,0,
158,285,222,3,25,57,0,1,0,2,0,2,1,598,0,10,608,0,
159,485,228,4,16,123,1,6,0,0,0,0,1,864,0,10,874,0,
160,547,317,6,30,97,0,5,0,0,0,0,,1004,0,10,1014,0,
161,439,197,3,19,64,1,0,0,0,0,1,1,725,0,13,738,0,
162,506,488,8,8,63,2,0,1,0,0,1,7,1084,0,20,1104,0,
163,597,307,5,9,44,1,2,0,2,3,5,10,985,0,24,1009,0,
164,362,270,2,1,9,0,0,0,2,1,7,5,659,0,17,676,0,
165,358,230,5,17,51,0,1,0,0,1,0,0,663,0,19,682,0,
166,434,249,1,8,34,0,2,0,2,1,1,0,732,0,9,741,0,
167,197,151,0,2,22,0,0,0,0,0,0,0,372,0,6,378,0,
168,352,366,5,14,39,2,0,0,1,0,2,4,785,0,10,795,0,
169,341,323,2,12,9,0,1,0,2,3,2,2,697,0,8,705,0,
170,343,392,4,5,25,1,1,1,1,0,5,2,780,0,7,787,0,
171,562,402,3,14,39,0,0,1,1,0,1,1,1024,0,12,1036,0,
172,471,397,4,26,64,0,1,0,2,0,1,2,968,0,25,993,0,
173,527,430,7,1,44,0,0,0,1,1,3,4,1018,0,11,1029,0,
174,342,238,3,9,23,5,0,0,3,0,1,2,626,0,5,631,0,
175,610,96,9,14,108,0,0,2,3,0,3,4,849,0,14,863,0,
176,261,465,4,9,89,1,1,2,2,3,4,1,842,0,11,853,0,
177,221,511,8,13,75,1,1,2,2,2,5,5,846,0,11,857,0,
178,641,287,6,14,49,0,1,0,2,3,2,4,1009,0,16,1025,0,
179,660,127,6,14,39,0,0,0,0,0,2,3,851,0,15,866,0,
180,157,403,4,13,91,1,2,1,3,1,1,4,681,0,9,690,0,
181,89,298,7,5,104,0,4,0,1,0,0,0,508,0,4,512,0,
182,159,362,6,6,92,1,1,0,4,3,1,3,638,0,9,647,0,
183,109,351,5,14,97,0,0,1,1,0,3,7,588,0,2,590,0,
184,341,230,1,9,53,0,1,0,0,2,1,2,640,0,5,645,0,
185,259,255,1,8,32,0,1,1,1,0,3,1,562,0,1,563,0,
186,472,480,2,13,52,1,0,0,3,0,2,5,1030,0,18,1048,0,
187,300,328,4,12,65,0,0,2,1,1,2,5,720,0,10,730,0,
188,226,293,7,7,55,0,0,1,2,3,1,2,597,0,7,604,0,
189,206,257,4,5,85,2,1,2,2,2,0,5,571,0,3,574,0,
190,165,368,2,6,72,1,0,0,2,2,2,0,620,0,5,625,0,
191,299,436,6,15,109,1,0,1,2,1,1,7,878,0,7,885,0,
192,291,369,6,13,71,0,0,0,1,1,2,6,760,0,11,771,0,
193,305,313,6,4,58,0,2,0,2,1,0,2,693,0,11,704,0,
194,296,427,9,12,103,3,0,4,3,3,1,1,862,0,8,870,0,
195,118,187,1,4,46,0,0,1,0,1,1,4,363,0,2,365,0,
196,241,355,4,11,61,0,0,0,1,3,0,2,678,0,15,693,0,
197,473,378,5,13,109,2,0,1,2,1,4,0,988,0,14,1002,0,
198,286,264,2,6,67,0,0,1,1,0,0,0,627,0,7,634,0,
199,354,324,2,6,74,1,1,1,0,1,2,0,766,0,5,771,0,
200,490,19,10,14,77,2,0,0,1,2,1,0,616,0,7,623,0,
201,424,171,6,16,56,0,1,1,0,1,3,3,682,0,6,688,0,
202,514,45,7,16,91,0,0,1,1,1,2,1,679,0,8,687,0,
203,532,467,4,11,40,0,3,1,0,0,4,3,1065,0,8,1073,0,
204,423,371,5,8,31,0,1,0,0,1,2,8,850,0,14,864,0,
205,152,170,0,5,21,0,0,0,0,1,0,0,349,0,2,351,0,
206,290,427,2,10,51,0,1,0,0,1,2,3,787,0,3,790,0,
207,396,511,3,10,62,0,0,0,0,1,2,3,988,0,10,998,0,
208,322,475,2,19,74,2,1,1,1,1,1,0,899,0,10,909,0,
209,205,322,4,18,59,2,1,0,0,0,0,0,611,0,11,622,0,
210,151,277,2,5,42,0,0,0,0,1,1,0,479,0,5,484,0,
211,180,257,4,9,97,0,0,1,0,0,0,1,549,0,4,553,0,
212,271,328,7,7,73,0,1,1,0,2,0,2,692,0,6,698,0,
213,203,315,2,1,54,0,1,0,2,0,1,1,580,0,6,586,0,
214,331,331,5,11,65,1,0,2,0,3,2,3,754,0,12,766,0,
215,300,381,1,11,78,0,0,1,1,4,2,1,780,0,5,785,0,
216,315,375,4,7,60,0,0,0,0,3,4,5,773,0,8,781,0,
217,198,376,5,6,68,0,1,1,0,0,2,2,659,0,0,659,0,
218,529,32,2,8,156,3,1,0,2,2,1,4,740,0,7,747,0,
219,509,449,9,10,81,1,0,1,5,2,1,3,1071,0,8,1079,0,
220,259,393,8,10,71,0,1,0,1,2,6,4,755,0,9,764,0,
221,241,411,8,7,37,1,0,0,1,1,0,2,709,0,1,710,0,
222,212,90,3,8,55,3,0,1,0,0,3,2,377,0,8,385,0,
223,517,11,6,17,187,2,0,2,3,1,2,2,750,0,11,761,0,
224,532,130,7,15,91,0,1,0,2,1,7,3,789,0,12,801,0,
225,361,125,11,13,162,2,0,3,0,1,2,0,680,0,9,689,0,
226,641,279,13,15,191,2,4,1,3,1,1,9,1160,0,8,1168,0,
227,513,206,8,21,173,0,1,0,0,1,2,2,927,0,7,934,0,
228,298,530,3,8,71,0,2,0,4,3,4,4,927,0,5,932,0,
229,195,399,12,7,136,0,1,2,9,7,3,7,778,0,8,786,0,
230,149,242,6,5,45,0,1,1,2,0,2,2,455,0,4,459,0,
231,198,414,8,3,95,2,1,0,4,4,4,7,740,0,7,747,0,
232,403,26,8,1,118,0,0,0,2,0,2,2,562,0,5,567,0,
233,345,235,13,21,274,0,0,0,3,2,1,4,898,0,10,908,0,
234,497,62,10,10,111,1,0,1,0,2,0,6,700,0,12,712,0,
235,335,34,12,23,145,1,1,0,1,1,0,2,555,0,9,564,0,
236,646,105,1,63,42,0,0,0,0,1,1,2,861,0,5,866,0,
237,546,11,6,17,95,1,0,0,2,0,1,0,679,0,3,682,0,
238,648,50,2,54,38,0,0,1,1,0,1,0,795,0,11,806,0,
239,212,306,2,3,15,0,1,0,0,0,0,0,539,0,4,543,0,
240,510,16,2,25,35,2,0,0,0,2,0,0,592,0,3,595,0,
241,370,504,4,8,15,1,1,0,1,3,3,3,913,0,8,921,0,
242,575,18,21,36,122,2,0,0,0,2,1,1,778,0,13,791,0,
243,196,7,6,10,70,1,0,1,1,0,2,0,294,0,6,300,0,
244,560,19,20,26,206,0,1,2,6,0,2,0,842,0,1,843,0,
245,286,164,7,11,48,1,0,0,1,3,5,2,528,0,0,528,0,
246,320,6,23,27,298,0,0,0,5,2,5,2,688,0,3,691,0,
247,466,10,23,41,215,4,0,1,2,1,4,6,773,0,5,778,0,
248,240,372,6,2,17,0,1,0,2,2,6,5,653,0,2,655,0,
249,336,398,15,12,143,2,0,2,0,4,4,11,927,0,5,932,0,
250,461,32,14,33,177,1,0,0,0,1,4,3,726,0,4,730,0,
251,420,12,15,22,161,2,2,3,2,0,4,2,645,0,5,650,0,
252,242,312,3,2,30,0,1,1,1,6,6,3,607,0,3,610,0,
253,701,137,15,26,216,0,0,2,2,2,5,5,1111,0,14,1125,0,
254,668,38,15,17,202,1,0,0,1,2,6,1,951,0,7,958,0,
255,546,16,17,20,246,1,0,2,2,1,3,0,854,0,11,865,0,
256,464,54,14,25,124,1,0,3,1,0,1,1,688,0,10,698,0,
257,271,319,3,14,71,0,1,1,1,3,3,3,690,0,4,694,0,
258,623,129,19,38,136,0,1,1,4,1,5,9,966,0,13,979,0,
259,757,63,12,15,130,1,0,0,1,2,1,2,984,0,13,997,0,
260,629,56,7,43,60,0,0,1,1,2,3,5,807,0,13,820,0,
261,870,23,11,42,80,0,2,0,0,7,6,4,1045,0,14,1059,0,
262,622,7,16,21,364,2,0,1,1,5,3,1,1043,0,14,1057,0,
263,363,233,7,25,114,2,2,2,1,0,2,4,755,0,4,759,0,
264,172,273,3,5,31,0,3,0,2,1,3,9,502,0,6,508,0,
265,423,204,16,17,115,3,2,1,0,1,5,2,789,0,6,795,0,
266,432,14,7,13,58,1,0,0,1,2,0,1,529,0,5,534,0,
267,618,15,10,72,70,1,1,0,3,2,8,0,800,0,13,813,0,
268,453,7,14,27,111,1,0,1,0,5,1,0,620,0,10,630,0,
269,257,526,11,5,30,1,0,2,0,3,3,14,852,0,14,866,0,
270,513,236,8,28,78,3,0,1,2,3,2,1,875,0,14,889,0,
271,915,21,14,24,59,0,0,0,0,5,5,0,1043,0,6,1049,0,
272,525,10,21,12,172,1,2,4,7,2,9,3,768,0,14,782,0,
273,553,15,14,15,121,1,2,2,3,2,2,4,734,0,14,748,0,
274,186,344,2,7,5,0,1,2,0,0,1,3,551,0,6,557,0,
275,357,176,8,5,55,0,0,0,2,1,1,3,608,0,4,612,0,
276,424,99,2,8,24,0,0,1,0,1,1,0,560,0,4,564,0,
277,488,4,3,26,27,0,0,1,0,1,1,2,553,0,7,560,0,
278,644,75,8,3,12,0,0,1,1,1,2,4,751,0,8,759,0,
279,170,315,2,2,14,0,0,0,0,0,3,2,508,0,7,515,0,
280,159,195,3,1,5,0,0,0,0,2,1,1,367,0,4,371,0,
281,562,546,10,8,27,1,1,1,2,5,9,7,1179,0,23,1202,0,
282,632,20,18,10,105,3,1,4,0,3,3,2,801,0,3,804,0,
283,321,53,8,24,45,0,0,0,0,2,3,0,456,0,12,468,0,
284,609,370,10,21,64,2,1,2,3,3,12,17,1114,0,11,1125,0,
285,626,195,0,0,2,0,0,0,0,0,0,5,828,0,9,837,0,
286,463,215,9,13,78,0,0,1,1,1,4,2,787,0,17,804,0,
287,385,670,8,11,25,0,1,1,5,6,5,7,1124,0,17,1141,0,
1,438,388,3,5,21,3,3,0,2,0,3,2,868,0,,9,877,0
2,133,406,7,5,19,0,0,0,0,3,1,4,578,0,,2,580,0
3,158,403,3,3,6,0,0,1,0,1,3,7,585,0,,8,593,0
4,214,378,3,4,11,0,0,0,0,2,2,1,615,0,,8,623,0
5,207,514,1,7,36,0,1,2,1,0,2,2,773,0,,11,784,0
6,180,399,5,11,16,1,2,0,0,2,1,2,619,0,,8,627,0
7,258,413,5,14,36,1,1,0,2,1,0,4,735,0,,11,746,0
8,351,195,2,4,32,0,0,0,0,1,1,1,587,0,,0,587,0
9,121,252,2,6,25,0,0,0,0,0,0,0,406,0,,4,410,0
10,377,330,3,8,13,0,1,2,3,1,3,4,745,0,,4,749,0
11,283,694,5,3,18,1,1,0,3,6,8,9,1031,0,,11,1042,0
12,372,697,3,7,20,1,0,2,4,0,2,3,1111,0,,16,1127,0
13,417,384,1,17,29,0,2,1,2,0,5,8,866,0,,10,876,0
14,455,30,2,94,26,0,1,1,1,1,5,4,620,0,,9,629,0
15,492,204,10,67,39,0,1,3,1,2,6,6,831,0,,15,846,0
16,518,42,1,13,12,0,1,0,0,0,0,2,589,0,,7,596,0
17,370,276,1,8,57,0,0,0,3,0,1,2,718,0,,11,729,0
18,284,289,4,7,29,0,2,0,0,2,5,2,624,0,,13,637,0
19,690,10,8,16,69,0,0,0,1,1,3,1,799,0,,4,"                       803
                             1",
20,727,39,2,26,58,0,0,2,3,3,8,2,870,0,9,879,0,
21,805,28,5,21,43,0,1,0,0,4,1,2,910,0,2,912,0,
22,707,46,11,43,76,0,0,0,0,1,2,1,887,0,8,895,0,
23,500,8,16,11,162,1,0,0,1,2,3,1,705,0,7,712,0,
24,557,3,10,6,80,0,0,0,1,4,4,1,666,0,2,668,0,
25,248,518,3,10,44,1,1,1,2,5,4,3,840,0,13,853,0,
26,276,455,3,20,42,0,1,0,2,3,4,2,808,0,13,821,0,
27,606,355,4,29,34,0,1,0,0,1,1,1,1032,0,6,1038,0,
28,673,72,5,25,186,3,0,2,2,0,2,1,971,0,8,979,0,
29,361,558,7,6,29,2,0,1,1,5,5,6,981,0,11,992,0,
30,840,23,4,8,12,1,2,0,0,0,1,1,892,0,10,902,0,
31,788,12,13,6,88,2,0,2,2,2,3,2,920,0,8,928,0,
32,209,521,8,4,81,1,3,1,1,2,6,2,839,0,10,849,0,
33,771,24,33,17,153,1,1,1,6,0,5,4,1016,0,12,1028,0,
34,985,52,17,51,57,2,1,2,2,2,3,4,1178,0,16,1194,0,
35,779,96,29,35,152,1,2,2,4,3,12,9,1124,0,14,1138,0,
36,505,18,6,12,78,1,1,0,0,0,1,2,624,0,6,630,0,
37,530,15,8,13,111,2,0,3,1,3,6,3,695,0,9,704,0,
38,181,198,1,11,52,0,0,0,0,1,1,2,447,0,2,449,0,
39,407,192,1,11,69,0,0,0,2,0,0,1,683,0,5,688,0,
40,302,326,4,19,89,0,0,1,0,1,2,2,746,0,10,756,0,
41,359,480,5,18,80,2,1,1,1,0,2,2,951,0,11,962,0,
42,416,251,5,8,104,1,3,4,1,1,2,2,798,0,11,809,0,
43,237,307,4,7,95,1,0,1,0,0,2,2,656,0,6,662,0,
44,261,248,4,13,49,2,1,1,1,0,0,1,581,0,6,587,0,
45,255,342,3,18,62,1,1,0,2,3,2,0,689,0,10,699,0,
46,234,219,1,12,63,0,0,0,1,0,0,2,532,0,11,543,0,
47,445,333,3,12,85,0,3,2,1,0,1,2,887,0,13,900,0,
48,447,274,4,16,61,0,2,1,1,1,1,0,808,0,21,829,0,
49,285,220,2,8,62,0,0,1,1,0,0,0,579,0,8,587,0,
50,572,362,7,5,133,0,1,2,4,2,10,10,1108,0,38,1146,0,
51,394,353,3,4,84,1,2,0,0,3,3,4,851,0,18,869,0,
52,292,266,4,19,93,1,2,1,1,0,2,1,682,0,17,699,0,
53,139,149,0,5,56,0,0,0,1,1,0,1,352,0,12,364,0,
54,290,205,2,12,63,0,0,1,0,1,1,2,577,0,8,585,0,
55,179,131,0,1,25,0,0,1,2,1,1,6,347,0,4,351,0,
56,310,310,8,14,103,0,2,0,0,2,4,2,755,0,23,778,0,
57,222,251,15,16,112,1,2,0,1,0,0,1,621,0,9,630,0,
58,106,165,8,3,61,1,0,1,5,0,1,1,352,0,4,356,0,
59,228,231,7,13,69,0,2,0,1,0,2,2,555,0,8,563,0,
60,343,337,5,27,157,1,0,0,0,0,0,1,871,0,11,882,0,
61,270,309,4,19,262,0,0,0,4,3,0,2,873,0,19,892,0,
62,263,294,9,22,219,0,2,0,0,0,0,1,810,0,14,824,0,
63,252,289,18,14,235,1,0,2,8,1,3,9,832,0,17,849,0,
64,268,259,8,17,148,1,1,0,2,0,0,1,705,0,12,717,0,
65,218,289,1,11,115,0,1,1,0,1,1,2,640,0,17,657,0,
66,197,176,6,13,134,0,3,1,1,1,0,0,532,0,8,540,0,
67,133,187,3,9,109,0,1,0,0,1,0,1,444,0,9,453,0,
68,243,203,3,17,53,0,0,0,1,1,0,0,521,0,10,531,0,
69,268,293,1,14,68,0,0,2,0,2,3,2,653,0,15,668,0,
70,344,371,2,15,79,0,1,1,0,1,2,2,818,0,5,823,0,
71,305,174,5,19,114,1,1,0,1,3,0,0,623,0,8,631,0,
72,279,241,2,6,107,0,2,0,0,0,0,0,637,0,11,648,0,
73,204,191,3,11,62,1,1,0,0,0,0,2,475,0,7,482,0,
74,413,221,3,15,92,0,0,0,2,1,0,2,749,0,22,771,0,
75,208,193,0,5,93,2,1,0,1,1,0,0,504,0,14,518,0,
76,248,305,5,7,45,1,0,1,2,1,0,3,                                  61C,0,4,622,0,
115,180,282,2,12,81,0,0,0,0,0,0,2,559,0,11,570,0,
116,198,399,2,16,29,0,0,0,1,2,1,5,653,0,4,657,0,
117,191,426,3,7,43,0,0,0,0,0,4,3,677,0,6,683,0,
118,164,299,2,10,64,0,0,0,0,2,1,0,542,0,0,542,0,
119,93,251,0,15,77,0,0,0,0,1,1,2,440,0,8,448,0,
120,839,22,4,31,53,1,0,0,0,1,0,0,951,0,10,961,0,
121,795,27,4,28,72,0,0,1,3,1,4,8,943,0,26,969,0,
122,331,213,2,7,83,1,2,0,1,0,0,3,643,0,2,645,0,
123,529,28,4,19,44,0,1,0,0,0,2,1,628,0,13,641,0,
124,749,19,2,17,58,0,0,1,0,0,5,3,854,0,19,873,0,
125,412,277,9,14,44,1,2,0,1,2,5,11,778,0,22,800,0,
126,512,20,14,9,100,0,1,1,3,2,4,0,666,0,7,673,0,
127,508,67,2,15,39,1,1,0,0,1,5,2,641,0,11,652,0,
128,380,534,4,14,86,1,0,3,0,0,0,3,1025,0,11,1036,0,
129,246,488,1,8,68,3,3,0,0,4,3,3,827,0,14,841,0,
130,380,437,5,7,98,1,1,1,2,1,5,8,946,0,6,952,0,
131,250,624,3,6,65,1,1,2,3,3,4,8,970,0,16,986,0,
132,252,339,5,12,76,0,0,0,0,0,1,2,687,0,15,702,0,
133,296,458,4,8,103,0,0,0,0,2,0,2,873,0,6,879,0,
134,221,274,1,6,44,0,0,0,1,2,0,1,550,0,11,561,0,
135,691,12,5,15,39,1,0,1,1,1,3,5,774,0,7,781,0,
136,536,11,3,13,45,1,0,0,1,2,1,0,613,0,8,621,0,
137,242,641,8,4,36,0,0,1,0,3,6,20,961,0,13,974,0,
138,230,496,3,8,32,1,2,0,1,5,5,6,789,0,11,800,0,
139,317,543,7,4,63,1,0,1,1,4,8,14,963,0,11,974,0,
140,317,433,4,5,75,0,1,1,1,1,0,1,839,0,8,847,0,
141,116,176,0,7,25,1,0,0,0,0,0,0,325,0,7,332,0,
142,183,306,0,8,64,0,1,0,3,2,1,0,568,0,8,576,0,
143,212,331,6,8,56,0,1,1,1,0,1,0,617,0,6,623,0,
144,133,250,8,4,123,0,0,0,1,1,1,0,521,0,3,524,0,
145,310,498,3,8,129,0,0,0,1,3,2,3,957,0,7,964,0,
146,232,308,8,8,64,1,0,0,0,1,1,0,623,0,5,628,0,
147,208,395,3,13,39,2,1,0,0,2,1,1,665,0,3,668,0,
148,192,386,1,2,24,0,0,0,0,1,1,3,610,0,7,617,0,
149,234,427,3,9,48,0,0,1,0,3,0,1,726,0,8,734,0,
150,767,23,3,14,55,2,2,2,1,2,10,7,888,0,34,922,0,
151,723,103,8,19,49,2,0,0,1,1,2,5,913,0,9,922,0,
152,703,67,9,30,96,0,0,0,1,2,4,4,916,0,15,931,0,
153,452,527,5,12,60,1,0,1,0,2,4,1,1065,0,7,1072,0,
154,900,15,3,36,47,0,2,0,0,3,2,4,1012,0,21,1033,0,
155,220,279,3,4,43,1,0,2,1,2,1,3,559,0,3,562,0,
156,294,374,3,6,64,0,0,1,1,1,2,3,749,0,3,752,0,
157,291,395,5,11,48,0,1,0,0,2,2,1,756,0,5,761,0,
158,412,508,2,8,67,0,1,0,1,2,1,1,1003,0,14,1017,0,
159,222,406,4,6,72,0,0,1,0,3,3,4,721,0,0,721,0,
160,333,295,4,3,63,0,1,0,1,0,3,0,703,0,8,711,0,
161,363,433,7,1,73,1,1,1,0,1,2,3,886,0,11,897,0,
162,182,379,9,8,209,1,2,1,3,2,3,2,801,0,10,811,0,
163,345,456,12,12,169,2,3,1,6,2,10,6,1024,0,13,1037,0,
164,337,464,6,15,48,1,0,0,2,1,3,1,878,0,10,888,0,
165,410,374,5,26,49,3,2,2,4,3,3,4,885,0,12,897,0,
166,274,280,6,23,29,2,0,0,0,1,0,0,615,0,6,621,0,
167,211,210,0,9,22,1,0,0,0,0,2,1,456,0,3,459,0,
168,368,396,4,20,148,3,0,0,0,3,3,4,949,0,5,954,0,
169,152,407,14,10,149,1,0,0,1,1,0,6,741,0,7,748,0,
170,264,294,5,20,65,0,0,2,0,2,2,0,654,0,7,661,0,
171,255,417,7,23,140,2,1,1,1,2,3,4,856,0,3,859,0,
172,293,311,4,11,68,2,0,1,3,2,2,3,700,0,7,707,0,
173,480,358,10,28,72,2,0,1,4,2,6,5,968,0,16,984,0,
174,177,240,1,7,71,0,1,0,3,2,1,2,505,0,5,510,0,
175,287,297,14,11,127,1,1,4,7,3,2,4,758,0,16,774,0,
176,709,80,25,15,195,3,2,3,10,4,16,6,1068,0,23,1091,0,
177,276,343,28,18,241,2,3,1,10,5,7,7,941,0,14,955,0,
178,205,368,3,14,17,1,1,1,1,0,6,3,620,0,8,628,0,
179,177,432,0,9,13,1,0,0,2,4,6,4,648,0,5,653,0,
180,456,543,5,6,14,1,2,2,5,4,3,10,1051,0,19,1070,0,
181,179,220,1,5,15,0,0,0,0,0,1,0,421,0,4,425,0,
182,174,423,2,10,29,0,1,1,1,3,7,4,655,0,7,662,0,
183,158,426,2,2,26,0,1,1,1,1,1,4,623,0,4,627,0,
184,162,476,2,3,18,0,0,1,3,1,4,4,674,0,5,679,0,
185,835,20,13,42,104,1,0,0,1,4,4,0,1024,0,20,1044,0,
186,351,553,3,17,59,0,1,0,3,0,4,2,993,0,13,1006,0,
187,245,343,4,7,12,0,0,2,0,2,3,6,624,0,8,632,0,
188,201,349,2,10,29,0,0,1,3,2,1,6,604,0,5,609,0,
189,407,701,3,5,35,0,2,1,4,0,4,7,1169,0,18,1187,0,
190,255,371,2,5,12,0,0,1,1,1,2,1,651,0,3,654,0,
191,143,387,10,3,65,2,4,1,8,2,5,5,635,0,5,640,0,
192,133,170,3,11,24,1,2,1,0,3,0,0,348,0,1,349,0,
193,155,281,6,3,53,2,0,0,0,1,4,4,509,0,10,519,0,
194,538,61,3,8,35,1,2,0,0,2,3,0,653,0,18,671,0,
195,266,402,6,13,57,0,0,1,2,1,0,1,749,0,3,752,0,
196,203,402,5,10,80,1,0,1,0,1,1,2,706,0,7,713,0,
197,228,275,4,13,73,1,0,1,1,1,1,2,600,0,5,605,0,
198,204,398,4,12,71,2,0,0,2,1,0,4,698,0,12,710,0,
199,538,170,2,10,59,0,3,1,1,0,1,4,789,0,8,797,0,
200,204,446,1,5,14,0,0,0,0,0,1,6,677,0,4,681,0,
201,192,255,2,14,64,0,1,0,0,1,0,0,529,0,5,534,0,
202,151,221,4,11,67,0,1,1,1,0,0,1,458,0,11,469,0,
203,254,234,7,13,83,1,3,0,0,1,1,1,598,0,17,615,0,
204,523,297,8,14,112,0,0,0,1,0,1,6,962,0,10,972,0,
205,295,291,2,14,57,0,1,0,0,0,0,2,662,0,10,672,0,
206,229,289,6,9,62,0,0,6,2,0,1,0,604,0,4,608,0,
207,343,434,3,6,33,0,1,0,1,2,4,1,828,0,9,837,0,
208,257,546,10,7,14,0,0,1,3,8,6,9,861,0,6,867,0,
209,453,360,6,3,16,0,0,0,0,2,8,17,865,0,42,907,0,
210,390,367,3,4,16,0,0,1,1,0,7,7,796,0,44,840,0,
211,283,354,0,10,67,1,0,0,0,1,2,2,720,0,8,728,0,
212,282,356,2,12,50,0,2,1,1,1,1,2,710,0,10,720,0,
213,249,221,0,8,84,0,0,0,0,0,0,0,562,0,7,569,0,
214,368,313,3,22,71,1,0,0,0,0,2,0,780,0,9,789,0,
215,383,381,3,4,59,0,0,0,3,4,4,4,845,0,15,860,0,
216,373,419,6,15,43,0,0,1,2,2,0,4,865,0,5,870,0,
217,198,191,3,5,86,1,0,0,0,0,0,0,484,0,14,498,0,
218,233,212,0,16,114,1,0,0,1,0,0,2,579,0,4,583,0,
219,311,469,1,22,98,3,2,1,0,2,3,0,912,0,9,921,0,
220,238,508,7,10,137,1,1,1,1,2,4,4,914,0,7,921,0,
221,110,227,3,4,62,1,1,0,0,2,2,2,414,0,2,416,0,
222,196,287,1,16,99,0,1,1,0,0,0,1,602,0,8,610,0,
223,349,340,4,12,92,1,0,0,0,1,0,3,802,0,8,810,0,
224,254,324,4,12,88,0,1,0,3,1,0,1,888,0,14,702,0,
225,219,270,1,15,123,0,2,0,0,1,0,3,634,0,17,651,0,
226,246,222,0,15,92,0,2,0,0,1,0,1,579,0,12,591,0,
227,270,294,0,8,94,1,1,1,4,0,2,2,677,0,9,686,0,
228,149,120,1,20,113,1,0,1,1,2,1,1,410,0,5,415,0,
229,230,307,8,14,134,0,3,0,1,1,1,2,701,0,6,707,0,
230,147,243,3,18,81,0,0,0,0,0,1,0,493,0,14,507,0,
231,214,274,11,7,117,2,1,0,0,4,2,1,633,0,9,642,0,
232,254,315,2,27,139,1,0,0,0,1,1,2,742,0,12,754,0,
233,163,172,3,7,99,0,0,0,1,1,1,0,447,0,10,457,0,
234,164,201,3,7,121,1,1,0,5,0,0,0,503,0,9,512,0,
235,217,260,0,24,92,0,1,1,0,2,1,1,599,0,11,610,0,
236,252,212,1,28,107,0,0,0,0,0,0,0,600,0,7,807,0,
237,166,211,2,16,95,1,0,0,0,1,0,0,492,0,12,504,0,
238,273,235,1,9,104,1,1,1,0,6,0,1,632,0,11,643,0,
239,195,193,2,13,83,0,2,1,0,2,0,2,493,0,14,507,0,
240,424,365,2,12,53,1,0,1,1,2,4,2,867,0,9,876,0,
241,271,493,4,14,49,0,0,0,0,3,0,4,838,0,15,853,0,
242,260,253,4,16,115,0,0,0,3,0,0,1,852,0,9,661,0,
243,217,274,2,20,59,0,1,0,0,1,0,0,574,0,13,587,0,
244,440,312,4,25,108,0,0,0,2,0,2,2,895,0,8,903,0,
245,211,545,3,7,30,1,3,2,4,0,9,11,826,0,11,837,0,
246,203,475,3,7,16,0,0,1,1,0,6,6,718,0,3,721,0,
247,269,258,4,7,102,2,0,0,0,1,0,0,643,0,14,657,0,
248,328,389,0,32,115,0,7,0,0,3,1,1,876,0,15,891,0,
249,274,414,5,11,31,0,1,0,1,2,7,5,751,0,7,758,0,
250,296,458,3,3,23,0,1,0,1,2,9,9,805,0,3,808,0,
251,265,376,2,4,19,1,7,1,4,3,5,14,701,0,10,711,0,
252,214,344,4,1,27,1,0,0,2,2,0,5,600,0,6,606,0,
253,208,377,2,5,24,1,0,0,1,2,4,6,630,0,10,640,0,
254,176,326,4,7,34,0,1,0,0,1,0,3,552,0,11,563,0,
255,279,291,2,24,127,1,0,0,0,1,2,1,728,0,10,738,0,
256,262,230,5,6,126,0,4,0,1,1,1,3,639,0,19,658,0,
257,587,284,8,9,54,1,2,0,2,1,4,4,956,0,19,975,0,
258,755,125,3,18,39,1,0,0,2,0,1,1,945,0,10,955,0,
259,402,554,0,3,37,0,0,1,2,2,3,5,1009,0,8,1017,0,
260,365,489,2,5,8,0,1,0,0,3,2,3,878,0,9,887,0,
261,395,339,5,8,44,0,3,1,1,0,0,0,796,0,12,808,0,
262,326,581,4,6,36,0,0,1,1,1,2,7,965,0,7,972,0,
263,255,452,3,5,10,1,2,2,3,4,3,4,744,0,4,748,0,
264,379,380,9,10,109,1,2,0,2,2,0,5,899,0,15,914,0,
265,378,492,10,12,67,1,0,0,0,0,1,5,966,0,17,983,0,
266,248,290,1,12,93,0,0,1,0,0,0,0,645,0,10,655,0,
267,205,249,4,16,92,2,1,1,1,0,0,1,572,0,14,586,0,
268,308,406,2,11,100,0,1,1,1,2,2,2,836,0,8,844,0,
269,228,285,2,14,51,0,1,0,1,0,3,1,586,0,4,590,0,
270,214,255,1,10,49,0,2,1,1,1,0,3,537,0,10,547,0,
271,305,499,0,4,27,0,1,1,0,3,2,4,846,0,6,852,0,
272,295,458,1,5,33,0,0,0,3,1,4,6,806,0,5,811,0,
273,235,279,6,17,57,0,7,0,4,2,2,2,611,0,15,626,0,
274,244,348,3,20,65,0,2,0,3,2,0,1,688,0,10,698,0,
275,234,381,1,18,103,0,1,1,3,3,1,3,749,0,14,763,0,
276,137,165,2,9,37,1,0,0,0,0,0,1,352,0,3,355,0,
277,279,327,4,54,125,0,4,0,0,2,0,2,797,0,21,818,0,
278,325,341,7,55,105,1,4,2,1,2,1,1,845,0,13,858,0,
279,349,394,4,21,101,1,8,0,1,1,3,5,888,0,12,900,0,
280,363,291,4,16,102,1,0,0,0,1,2,6,786,0,12,798,0,
281,286,333,9,14,91,0,5,0,1,0,0,1,740,0,8,748,0,
282,199,248,3,12,89,1,0,0,0,1,2,0,555,0,8,563,0,
283,359,515,13,16,69,0,0,2,2,2,0,1,979,0,19,998,0,
284,224,332,5,18,71,0,1,0,1,1,2,3,653,0,10,668,0,
285,199,255,0,6,33,0,0,0,0,0,1,1,495,0,18,513,0,
286,388,520,6,20,70,4,3,1,3,2,4,2,1023,0,15,1038,0,
287,261,333,7,12,90,0,0,0,0,0,0,1,704,0,8,712,0,
288,335,400,7,13,66,1,1,1,0,1,1,2,828,0,9,837,0,
289,191,240,2,11,40,1,0,0,3,3,0,1,492,0,10,502,0,
290,341,375,24,22,88,1,2,0,0,0,0,0,853,0,19,872,0,
291,173,216,8,19,105,1,1,2,1,0,0,1,527,0,12,539,0,
292,211,205,1,13,55,0,1,1,1,0,0,1,489,0,13,502,0,
1,587,4,13,9,181,1,0,2,2,1,4,1,805,0,5,810,0,
2,383,2,1,2,60,0,0,0,1,0,5,0,454,0,2,456,0,
3,522,9,8,13,147,1,0,0,1,1,1,2,705,0,7,712,0,
4,343,3,3,6,73,0,0,1,2,0,2,1,434,0,7,441,0,
5,380,635,6,9,40,1,0,4,3,3,12,21,1114,0,10,1124,0,
6,274,2,17,5,174,0,0,0,0,2,1,0,475,0,2,477,0,
7,883,5,9,9,98,1,2,0,1,1,2,6,1017,0,15,1032,0,
8,524,269,7,6,41,1,0,2,0,1,6,6,863,0,11,874,0,
9,589,58,4,16,33,1,0,0,0,0,4,3,708,0,5,713,0,
10,892,21,4,22,52,1,0,0,1,1,1,0,995,0,14,1009,0,
11,424,285,3,3,9,1,1,1,0,0,0,0,727,0,2,729,0,
12,304,425,5,23,19,1,0,0,5,4,11,16,813,0,15,828,0,
13,406,382,7,2,7,0,0,0,0,1,5,6,816,0,9,825,0,
14,576,13,12,13,183,0,1,1,0,0,3,6,808,0,16,824,0,
15,676,41,10,11,68,1,0,0,2,0,4,3,816,0,8,824,0,
16,560,10,7,6,52,0,0,1,1,1,2,1,641,0,5,646,0,
17,463,26,16,22,125,2,0,0,0,2,6,3,665,0,5,670,0,
18,225,379,7,6,16,0,0,1,1,0,5,7,647,0,3,650,0,
19,181,357,4,1,3,0,0,1,1,2,2,4,556,0,6,562,0,
20,464,41,7,5,125,0,0,2,2,3,3,0,652,0,9,661,0,
21,464,56,1,11,11,0,0,1,1,2,3,2,552,0,2,554,0,
22,577,10,7,18,28,0,0,0,0,0,0,1,641,0,0,641,0,
23,556,21,15,18,74,0,0,0,6,0,3,1,694,0,11,705,0,
24,623,14,8,12,65,0,1,2,1,2,3,0,731,0,3,734,0,
25,426,294,5,11,38,2,1,0,1,3,5,4,790,0,15,805,0,
26,362,331,11,7,27,1,3,0,2,3,4,4,755,0,10,765,0,
27,654,7,5,20,69,0,0,0,0,1,1,0,757,0,5,762,0,
28,719,5,5,37,58,0,0,1,0,0,1,0,826,0,5,831,0,
29,812,38,6,13,28,0,0,0,2,2,10,7,918,0,22,940,0,
30,891,38,6,9,59,2,2,1,3,1,13,3,1028,0,      12 j,1040,0,
31,903,8,6,66,34,1,0,0,2,0,2,0,1022,0,11,1033,0,
32,513,122,5,7,52,0,0,0,3,0,3,2,707,0,9,716,0,
33,522,10,4,28,84,2,0,1,0,1,2,1,655,0,2,657,0,
34,579,9,4,4,42,1,0,0,1,1,4,0,645,0,10,655,0,
35,652,2,1,7,29,0,0,0,0,0,2,2,695,0,10,705,0,
36,547,412,4,9,56,0,2,0,2,1,4,5,1042,0,15,1057,0,
37,821,103,5,22,99,0,0,0,1,2,2,3,1058,0,7,1065,0,
38,281,593,4,4,10,1,0,2,0,1,2,3,901,0,13,914,0,
39,855,39,12,17,96,3,0,2,1,2,8,2,1037,0,15,1052,0,
40,457,266,3,6,34,0,1,1,1,2,3,0,774,0,12,786,0,
41,164,334,5,11,13,0,2,0,1,0,0,3,533,0,2,535,0,
42,721,17,6,24,49,0,0,0,1,0,1,0,819,0,13,832,0,
43,494,70,1,13,24,0,0,0,1,0,1,2,606,0,8,614,0,
44,272,367,2,3,3,0,0,0,0,3,4,6,660,0,11,671,0,
45,421,416,6,9,13,0,0,0,0,3,2,7,877,0,26,903,0,
46,806,144,4,7,23,1,0,2,2,1,8,4,1002,0,24,1026,0,
47,422,278,2,20,19,0,0,1,1,0,3,6,752,0,16,768,0,
48,801,5,0,11,7,1,0,0,0,0,0,1,826,0,1,827,0,
49,651,8,8,16,69,1,0,0,2,1,2,1,759,0,6,765,0,
50,547,168,2,14,6,0,0,0,1,1,3,2,744,0,6,750,0,
51,532,37,2,17,35,0,0,0,0,1,3,1,628,0,8,636,0,
52,365,383,1,5,7,0,0,0,4,2,4,12,783,0,15,798,0,
53,246,286,4,4,5,1,0,0,0,2,5,2,555,0,9,564,0,
54,232,391,2,1,0,0,1,0,0,1,4,4,636,0,13,649,0,
55,469,502,1,3,5,0,2,2,0,0,3,8,995,0,21,1016,0,
56,278,513,4,4,7,0,1,0,0,3,8,9,827,0,15,842,0,
57,643,5,3,23,40,1,0,1,0,0,2,1,719,0,3,722,0,
58,422,8,5,26,51,1,0,0,0,2,1,1,517,0,1,518,0,
59,649,4,2,50,8,0,1,0,0,0,1,0,715,0,7,722,0,
60,454,1,3,73,46,1,0,1,0,0,6,1,586,0,1,587,0,
61,951,15,9,20,81,0,1,2,6,3,10,5,1103,0,4,1107,0,
62,338,698,4,9,8,1,1,1,6,3,5,13,1087,0,16,1103,0,
63,517,405,3,13,32,0,0,0,0,1,1,3,975,0,17,992,0,
64,626,102,12,24,49,2,1,0,0,4,5,2,827,0,5,832,0,
65,246,625,10,4,13,1,1,2,3,3,2,6,916,0,11,927,0,
66,640,15,4,31,49,2,1,1,0,1,7,2,753,0,8,761,0,
67,297,588,4,8,13,0,0,4,2,2,7,10,935,0,9,944,0,
68,592,4,11,6,154,2,1,0,1,3,3,4,781,0,14,795,0,
69,311,388,10,8,88,3,1,1,2,0,3,3,818,0,6,824,0,
70,384,537,7,7,27,0,2,0,5,7,6,7,989,0,11,1000,0,
71,234,169,2,4,8,0,0,1,1,0,3,2,424,0,2,426,0,
72,532,169,2,15,28,0,1,0,0,2,3,5,757,0,4,761,0,
73,525,15,9,42,94,2,0,0,1,0,0,2,690,0,3,693,0,
74,187,292,2,1,4,0,1,0,1,0,0,0,488,0,2,490,0,
75,243,324,0,6,13,0,0,0,0,0,3,2,591,0,8,599,0,
76,527,19,6,5,207,0,0,0,1,4,2,0,771,0,2,773,0,
77,391,226,11,9,128,0,0,0,1,4,12,7,789,0,10,799,0,
78,452,201,3,14,65,3,3,0,0,0,3,2,746,0,4,750,0,
79,456,25,12,20,286,7,1,1,2,1,3,2,816,0,4,820,0,
80,380,43,5,9,34,0,0,0,0,1,1,0,473,0,3,476,0,
81,309,3,9,46,123,0,0,0,4,0,2,3,499,0,4,503,0,
82,418,9,6,43,110,3,1,1,1,1,3,0,596,0,10,606,0,
83,411,358,2,2,9,1,0,1,2,3,2,4,795,0,12,807,0,
84,354,2,9,13,101,1,3,3,0,2,2,2,492,0,4,496,0,
85,751,39,14,33,156,1,0,1,1,2,1,5,1004,0,15,1019,0,
86,602,115,3,14,7,1,2,0,0,1,0,3,748,0,11,759,0,
87,834,9,7,65,39,2,0,2,1,2,7,1,969,0,26,995,0,
88,470,13,7,117,21,0,1,0,0,0,4,2,635,0,4,639,0,
89,447,42,11,92,102,2,0,2,2,0,4,1,705,0,6,711,0,
90,441,5,5,22,60,1,0,1,1,0,0,0,536,0,2,538,0,
91,337,366,7,7,26,0,1,1,3,5,7,4,764,0,12,776,0,
92,384,2,1,13,31,0,0,1,1,0,1,0,434,0,9,443,0,
93,152,359,2,1,4,0,5,0,1,0,1,6,531,0,3,534,0,
94,212,428,5,6,5,2,1,2,2,6,2,7,678,0,9,687,0,
95,640,12,8,5,75,0,0,2,3,5,8,2,760,0,9,769,0,
96,347,2,4,10,91,0,0,0,0,3,0,0,457,0,5,462,0,
97,518,37,4,23,189,1,1,2,1,2,4,1,783,0,10,793,0,
98,380,6,7,56,176,2,2,1,1,2,0,1,634,0,2,636,0,
99,538,6,5,22,157,1,1,0,2,3,2,0,737,0,8,745,0,
100,353,216,4,7,146,0,0,2,3,1,3,5,740,0,5,745,0,
101,452,8,19,181,241,3,0,3,3,2,8,4,924,0,3,927,0,
102,344,47,6,105,75,1,0,1,3,2,2,2,588,0,4,592,0,
103,534,50,0,9,8,0,0,0,0,0,0,0,601,0,5,606,0,
104,327,268,4,11,10,1,1,2,2,2,9,3,640,0,9,649,0,
105,369,8,8,84,152,1,2,0,0,1,1,2,628,0,9,637,0,
106,641,176,11,51,64,2,1,1,1,5,4,5,962,0,14,976,0,
107,599,5,18,28,295,4,2,1,0,1,1,0,954,0,3,957,0,
108,683,267,3,38,102,0,0,2,0,4,6,7,1112,0,      14  ;,1126,0,
109,548,200,2,10,37,0,1,1,2,0,11,5,817,0,8,825,0,
110,195,7,9,15,140,0,0,0,1,1,1,1,370,0,7,377,0,
111,150,659,2,15,39,1,0,1,1,1,1,4,874,0,8,882,0,
112,447,511,3,5,78,0,0,1,2,1,2,6,1056,0,7,1063,0,
113,564,230,2,55,26,0,3,0,0,1,2,3,886,0,7,893,0,
114,683,18,8,29,127,0,3,1,3,1,4,2,879,0,4,883,0,
115,347,23,9,78,81,0,0,1,3,1,4,4,551,0,8,559,0,
116,400,109,4,54,67,0,0,0,0,0,1,2,637,0,0,637,0,
117,341,143,6,120,42,1,0,0,0,0,0,3,656,0,3,659,0,
118,133,457,1,13,23,1,0,0,0,1,3,4,636,0,3,639,0,
119,516,39,9,143,25,1,0,0,3,2,3,2,743,0,11,754,0,
120,503,14,17,30,80,3,0,2,1,4,1,4,659,0,11,670,0,
121,560,5,6,17,107,1,2,2,1,0,4,2,707,0,10,717,0,
122,571,7,5,138,44,1,0,2,1,2,0,2,773,0,4,777,0,
123,646,8,4,33,33,1,0,1,2,2,6,2,738,0,14,752,0,
124,640,9,18,78,103,0,1,0,5,5,10,3,872,0,8,880,0,
125,731,50,9,80,72,1,2,1,0,1,7,5,959,0,12,971,0,
126,432,44,5,30,19,0,1,1,2,0,1,2,537,0,6,543,0,
127,749,143,8,134,54,2,8,2,2,2,5,3,1112,0,22,1134,0,
128,314,76,3,57,41,0,2,0,3,4,3,1,504,0,0,504,0,
129,458,542,10,18,30,0,3,0,1,4,2,2,1070,0,8,1078,0,
130,644,34,11,96,108,3,6,2,1,2,4,4,915,0,5,920,0,
131,614,12,20,156,282,2,10,0,1,4,4,4,1109,0,8,1117,0,
132,417,106,2,139,23,1,0,1,3,2,7,8,709,0,15,724,0,
133,673,14,14,166,131,1,1,1,1,5,4,2,1013,0,12,1025,0,
134,698,109,6,214,53,1,0,0,2,4,6,6,1099,0,5,1104,0,
135,373,360,8,150,19,1,1,1,2,3,9,4,931,0,14,945,0,
136,255,1,2,207,9,0,4,1,0,0,1,0,480,0,2,482,0,
137,386,6,4,241,35,1,0,0,0,1,5,3,682,0,6,688,0,
138,710,16,6,266,73,0,1,2,0,1,3,0,1078,0,2,1080,0,
139,413,14,8,52,166,1,1,0,0,0,0,0,655,0,6,661,0,
140,433,5,20,55,128,0,1,0,4,1,6,1,654,0,10,664,0,
141,343,470,6,58,53,0,0,1,0,2,0,2,935,0,10,945,0,
142,171,309,1,20,8,1,1,0,1,1,1,3,517,0,4,521,0,
143,350,188,3,45,46,0,0,1,0,1,0,2,636,0,2,638,0,
144,537,65,0,83,6,1,1,0,0,0,3,0,696,0,4,700,0,
145,417,7,2,410,42,0,0,0,0,1,1,2,882,0,3,885,0,
146,223,7,1,96,39,0,2,0,0,0,3,0,371,0,"      2  ,",373,0,
147,526,25,3,193,64,0,0,0,0,2,2,1,816,0,      1  ?,817,0,
148,162,577,3,12,16,2,0,0,3,4,5,3,787,0,3,790,0,
149,121,455,5,10,5,2,1,1,1,1,2,2,606,0,10,616,0,
150,224,354,1,32,21,0,2,2,1,2,1,4,644,0,6,650,0,
151,415,189,10,65,33,1,1,1,1,4,8,3,731,0,8,739,0,
152,264,320,3,11,13,0,0,0,0,1,0,1,613,0,6,619,0,
153,275,496,4,9,29,0,2,1,2,4,3,7,832,0,12,844,0,
154,202,402,1,2,15,0,0,0,0,0,7,4,633,0,4,637,0,
155,494,138,3,171,33,0,7,0,1,0,2,2,851,0,5,856,0,
156,260,646,6,14,48,0,4,0,0,3,4,4,989,0,6,995,0,
157,197,209,1,5,40,0,0,0,0,0,0,1,453,0,2,455,0,
158,137,647,5,7,22,0,0,0,0,0,2,2,822,0,5,827,0,
159,179,318,0,4,9,0,1,0,0,2,0,1,514,0,1,515,0,
160,159,597,2,6,31,1,3,0,1,2,0,0,802,0,3,805,0,
161,162,570,7,9,54,0,1,0,2,2,4,2,813,0,3,816,0,
162,137,346,2,6,29,0,0,0,0,0,0,3,523,0,1,524,0,
163,207,405,5,9,31,3,3,3,3,3,4,4,680,0,4,684,0,
164,268,489,8,18,102,0,1,0,1,3,4,2,896,0,8,904,0,
165,402,5,6,7,201,2,0,1,0,1,5,0,630,0,10,640,0,
166,619,8,12,13,108,1,1,0,5,2,4,1,774,0,13,787,0,
167,378,590,4,7,83,0,1,2,1,3,2,5,1076,0,4,1080,0,
168,713,11,22,14,140,0,1,2,1,3,1,2,910,0,12,922,0,
169,479,258,10,12,142,0,1,0,0,1,0,1,904,0,4,908,0,
170,354,546,4,17,25,1,2,1,1,0,5,1,957,0,17,974,0,
171,551,13,16,142,172,0,1,0,1,0,1,0,897,0,4,901,0,
172,615,11,4,35,161,0,0,1,1,0,0,2,830,0,7,837,0,
173,273,40,6,98,33,0,0,3,1,0,1,2,457,0,1,458,0,
174,210,328,6,49,30,0,0,1,3,0,2,0,629,0,4,633,0,
175,587,11,18,152,178,0,0,3,1,1,2,2,955,0,12,967,0,
176,618,14,4,50,81,0,0,2,0,0,2,1,772,0,4,776,0,
177,566,4,5,53,40,0,0,0,0,0,4,1,673,0,11,684,0,
178,624,94,7,89,82,0,1,1,2,4,2,5,911,0,13,924,0,
179,362,255,3,10,24,0,0,0,2,0,3,5,664,0,15,679,0,
180,523,112,8,73,71,2,0,1,1,2,5,2,800,0,4,804,0,
181,476,7,12,80,230,3,1,0,1,2,3,2,817,0,6,823,0,
182,532,99,2,127,24,0,0,0,"      0   """,1,4,0,789,0,11,800,0,
183,285,10,7,190,51,0,0,2,1,2,2,1,551,0,1,552,0,
184,607,7,9,69,91,0,0,1,0,4,7,2,797,0,13,810,0,
185,202,72,5,81,181,1,0,0,7,2,3,2,556,0,2,558,0,
186,607,194,13,73,121,1,1,3,1,3,3,2,1022,0,      9  ?,1031,0,
187,452,37,15,91,335,2,3,5,1,2,3,1,947,0,9,956,0,
188,475,84,10,64,302,2,1,0,6,3,3,2,952,0,12,964,0,
189,430,287,2,24,56,1,0,0,1,2,3,6,812,0,6,818,0,
190,228,90,3,32,47,0,1,1,0,1,0,0,403,0,5,408,0,
191,583,181,7,57,24,1,3,0,0,2,2,2,862,0,11,873,0,
192,495,228,1,41,42,0,1,0,0,0,1,1,810,0,4,814,0,
193,252,3,9,33,246,3,0,1,3,0,0,0,550,0,7,557,0,
194,524,5,6,78,130,1,0,1,0,2,2,0,749,0,6,755,0,
195,329,12,8,237,89,0,0,0,1,3,2,0,681,0,3,684,0,
196,504,66,14,111,270,0,0,0,8,3,4,1,981,0,10,991,0,
197,371,254,3,76,49,1,1,1,3,4,4,3,770,0,8,778,0,
198,689,32,8,121,85,1,0,0,3,3,6,5,953,0,12,965,0,
199,607,62,17,54,238,1,2,1,4,1,4,4,995,0,9,1004,0,
200,297,132,1,145,26,1,1,2,1,4,1,3,614,0,4,618,0,
201,414,18,6,112,55,2,0,2,1,2,2,1,615,0,4,619,0,
202,266,29,7,98,141,2,0,0,3,1,0,1,548,0,5,553,0,
203,181,111,19,84,225,0,1,0,3,2,1,1,628,0,1,629,0,
204,237,3,2,72,29,2,0,1,0,0,0,0,346,0,2,348,0,
205,379,3,8,50,286,1,0,2,6,1,3,0,739,0,8,747,0,
206,535,7,3,106,159,0,0,1,1,2,0,2,816,0,6,822,0,
207,329,2,6,18,117,3,1,0,1,0,0,0,477,0,3,480,0,
208,408,4,11,49,165,0,1,0,0,0,1,0,639,0,2,641,0,
209,548,347,6,45,155,0,0,0,4,0,0,2,1107,0,14,1121,0,
210,509,321,2,96,23,0,0,0,0,0,0,0,951,0,6,957,0,
211,589,175,6,22,78,0,0,0,1,1,1,1,874,0,2,876,0,
212,111,201,0,3,1,0,0,0,0,0,1,1,318,0,0,318,0,
213,445,2,9,36,81,3,0,0,0,1,2,1,580,0,3,583,0,
214,479,77,8,62,61,0,1,0,1,2,1,3,695,0,10,705,0,
215,421,4,8,145,63,0,0,1,0,0,0,0,642,0,0,642,0,
216,647,165,8,69,198,0,0,2,1,1,4,4,1099,0,16,1115,0,
217,180,412,4,4,34,0,0,3,2,3,3,7,652,0,4,656,0,
218,396,114,5,18,11,1,0,1,0,0,2,1,549,0,12,561,0,
219,577,3,2,32,31,0,0,0,0,0,0,1,646,0,4,650,0,
220,590,19,6,67,126,1,0,0,1,0,0,3,813,0,5,818,0,
221,353,139,2,25,23,1,1,1,1,2,3,7,558,0,8,566,0,
222,265,424,1,3,6,0,0,1,0,1,5,8,714,0,8,722,0,
223,526,5,14,28,224,3,1,2,1,2,1,2,809,0,8,817,0,
224,569,8,3,11,70,1,1,0,3,1,2,0,669,0,7,   ' 676,0,
225,281,7,4,10,169,0,1,1,3,0,0,0,476,0,2,478,0,
226,492,331,6,28,42,1,0,1,1,2,4,10,918,0,19,937,0,
227,474,137,13,51,100,1,1,0,0,4,4,3,788,0,7,795,0,
228,313,21,15,45,48,1,0,1,0,2,1,4,451,0,4,455,0,
229,504,46,8,42,66,0,0,1,1,1,2,5,676,0,9,685,0,
230,550,28,9,124,85,0,1,0,0,1,3,3,804,0,9,813,0,
231,458,196,6,53,180,1,1,1,1,5,5,2,909,0,5,914,0,
232,642,119,10,157,143,1,0,2,3,4,2,1,1084,0,10,1094,0,
233,599,7,12,51,288,1,1,0,1,1,1,1,963,0,5,968,0,
234,308,16,4,39,73,1,0,0,4,2,2,0,449,0,2,451,0,
235,1033,28,0,41,21,1,0,0,0,0,1,1,1126,0,1,1127,0,
236,324,215,5,11,21,0,0,0,0,2,2,1,581,0,8,589,0,
237,412,297,4,36,15,1,1,0,1,0,6,3,776,0,0,776,0,
238,196,449,3,1,4,0,0,1,0,0,2,1,657,0,5,662,0,
239,100,440,1,1,2,0,0,0,2,1,5,5,557,0,7,564,0,
240,238,752,5,3,13,1,1,3,2,1,2,4,1025,0,15,1040,0,
241,126,356,1,3,5,0,0,0,0,0,3,3,497,0,0,497,0,
242,617,37,14,13,85,1,2,0,1,1,5,2,778,0,8,786,0,
243,300,555,3,7,11,0,0,0,0,0,0,0,876,0,5,881,0,
244,442,285,3,4,10,1,0,0,0,0,3,1,749,0,2,751,0,
245,391,79,6,22,123,0,0,0,1,3,2,4,631,0,3,634,0,
246,475,9,14,102,243,1,0,1,2,1,2,1,851,0,4,855,0,
247,378,98,10,62,137,0,0,1,2,1,1,1,691,0,4,695,0,
248,637,9,13,14,162,0,0,2,1,2,3,1,844,0,2,846,0,
249,423,19,6,71,168,0,2,1,1,0,2,1,694,0,9,703,0,
250,594,150,4,31,185,0,12,1,0,0,4,0,981,0,5,986,0,
251,374,3,3,46,29,0,0,1,0,0,1,0,457,0,0,457,0,
252,338,98,15,206,91,0,0,1,1,4,4,6,764,0,8,772,0,
253,305,15,4,12,81,0,1,0,0,1,1,0,420,0,2,422,0,
254,509,52,9,33,159,2,1,4,2,3,1,1,776,0,9,785,0,
