Serial No. of Polling Station,ABUL KASHEM DHALI,QUAZI ABDUR RAHIM,NUSRATJAHAN RUHI,PALLAB SENGUPTA,SAYANTAN BASU,AJAY KUMAR BAIN,IMAMUL HASAN MALLIK,MD. TABAROK HOSSAIN MOLLA,MIZANOOR RAHMAN,AMIYASARKAR,ABDUL HAN NAN SARDAR,PARIMAL MISTRI,SUBHASIS KUMAR BHOWMIK,Total of valid votes,No. of Rejected Votes (Test Votes),Votes for NOTA option,Total Votes,No. of tendered votes
1,0,85,492,99,139,5,0,1,0,0,2,2,3,828,0,6,834,0
2,2,44,157,43,574,4,2,0,0,3,3,3,0,835,0,5,840,0
3,0,4,118,29,466,5,0,1,0,2,0,0,0,625,0,1,626,0
4,0,0,0,0,0,0,0,0,0,0,0,0,0,0,0,0,0,0
5,3,10,233,22,141,0,0,0,0,1,0,6,1,417,0,0,417,0
6,3,8,277,77,340,1,1,0,0,0,0,3,0,710,0,1,711,0
7,2,17,200,45,482,3,0,0,1,1,0,1,1,753,0,3,756,0
8,1,20,230,9,245,1,2,1,3,4,1,5,3,525,0,6,531,0
9,1,140,387,26,62,0,1,1,1,0,2,6,2,629,0,5,634,0
10,1,6,271,20,573,1,2,0,1,0,1,2,2,880,0,2,882,0
11,0,0,0,0,0,0,0,0,0,0,0,0,0,0,0,0,0,0
12,4,17,464,69,12,1,0,0,0,0,0,1,1,569,0,0,569,0
13,2,9,316,31,173,0,0,0,0,1,0,4,0,536,0,2,538,0
14,0,9,430,131,74,0,1,1,2,1,2,5,0,656,0,2,658,0
15,1,16,343,65,439,2,0,0,0,1,0,6,1,874,0,7,881,0
16,0,14,179,63,525,5,0,0,0,1,0,1,0,788,0,3,791,0
17,1,7,235,42,695,3,0,1,0,1,1,1,2,989,0,7,996,0
18,2,20,217,35,689,4,0,2,4,2,0,1,0,976,0,7,983,0
19,1,10,140,36,488,4,1,1,0,2,0,1,0,684,0,7,691,0
20,4,12,176,37,472,3,2,1,2,3,1,1,1,715,0,4,719,0
21,1,16,145,35,667,4,1,0,0,1,0,1,0,871,0,3,874,0
22,2,46,415,59,319,2,2,1,0,2,6,10,4,868,0,4,872,0
23,2,1,77,8,333,1,0,1,1,0,1,1,0,426,0,0,426,0
24,3,10,343,43,213,3,0,0,1,1,0,4,0,621,0,1,622,0
25,3,80,658,92,260,3,1,1,1,1,3,8,1,1112,0,2,1114,0
26,1,28,340,20,152,0,1,2,0,1,1,3,3,552,0,1,553,0
27,0,0,0,0,0,0,0,0,0,0,0,0,0,0,0,0,0,0
28,2,31,444,33,220,0,0,0,2,0,1,4,2,739,0,2,741,0
29,3,6,91,18,632,2,0,0,1,6,2,4,1,766,0,4,770,0
30,0,22,85,26,472,1,0,2,0,4,1,4,2,619,0,2,621,0
31,0,9,65,34,357,0,0,0,0,1,1,0,0,467,0,1,468,0
32,3,39,111,43,581,2,0,3,1,1,1,2,2,789,0,5,794,0
33,5,8,290,27,508,2,1,0,0,5,0,4,3,853,0,3,856,0
34,0,1,110,6,155,0,0,0,0,5,0,2,1,280,0,1,281,0
35,1,12,161,5,173,2,0,2,0,2,2,0,0,360,0,1,361,0
36,1,139,309,29,65,1,0,7,1,1,0,1,2,556,0,2,558,0
37,0,74,373,40,87,1,1,4,0,1,0,2,0,583,0,0,583,0
38,1,30,391,33,36,0,0,0,0,1,1,0,0,493,0,1,494,0
39,1,20,160,11,401,1,0,1,0,1,0,2,1,599,0,0,599,0
40,0,8,88,6,353,2,1,0,0,2,1,0,0,461,0,5,466,0
41,1,23,286,12,492,1,1,0,1,5,0,2,1,825,0,2,827,0
42,0,86,685,23,186,1,0,3,2,0,1,7,1,995,0,7,1002,0
43,2,8,135,14,492,2,0,0,1,4,3,2,2,665,0,1,666,0
44,3,120,702,80,160,1,6,6,2,6,2,6,2,1096,0,5,1101,0
45,1,78,321,17,17,1,0,0,0,1,3,1,0,440,0,1,441,0
46,1,46,586,23,11,0,2,0,1,2,0,3,3,678,0,1,679,0
47,3,104,506,22,9,0,0,4,1,0,0,4,1,654,0,2,656,0
48,4,125,463,108,222,2,0,1,1,0,6,6,0,938,0,1,939,0
49,1,28,468,62,83,0,0,0,0,1,3,5,3,654,0,4,658,0
50,4,57,289,52,209,0,0,0,1,3,2,6,2,625,0,1,626,0
51,1,99,737,49,57,3,2,4,0,0,0,6,0,958,0,0,958,0
52,1,69,698,25,17,0,0,2,0,0,0,4,0,816,0,3,819,0
53,2,279,442,18,14,2,2,2,1,2,1,5,0,770,0,4,774,0
54,1,99,500,23,22,1,0,2,2,1,2,3,0,656,0,3,659,0
55,2,226,428,19,67,0,1,7,0,0,0,11,5,766,0,5,771,0
56,0,133,535,4,5,0,0,1,0,0,1,0,1,680,0,3,683,0
57,1,59,312,62,289,0,1,2,1,5,1,5,3,741,0,3,744,0
58,4,172,371,41,8,0,2,3,0,0,3,3,1,608,0,4,612,0
59,2,28,244,119,78,0,0,0,0,0,0,3,0,474,0,2,476,0
60,4,82,387,157,168,1,0,4,0,1,1,9,0,814,0,3,817,0
61,0,138,309,11,1,3,0,0,0,0,0,3,0,465,0,3,468,0
62,2,217,472,6,17,0,0,10,0,1,3,4,1,733,0,3,736,0
63,1,43,224,38,455,2,0,0,2,2,2,0,2,771,0,8,779,0
64,7,60,267,47,623,2,2,4,1,6,3,7,7,1036,0,10,1046,0
65,2,206,583,40,63,1,3,2,0,1,6,4,2,913,0,4,917,0
66,5,132,527,74,123,0,1,6,1,0,2,5,0,876,0,7,883,0
67,2,191,607,61,11,0,0,3,0,2,0,7,4,888,0,4,892,0
68,4,124,435,89,36,2,2,3,2,1,0,3,3,704,0,1,705,0
69,1,223,583,67,85,3,1,2,1,2,1,6,5,980,0,7,987,0
70,1,58,381,16,8,1,2,1,1,1,2,7,4,483,0,1,484,0
71,3,25,259,26,558,2,1,4,0,7,1,2,2,890,0,4,894,0
72,2,98,564,129,260,6,2,2,5,3,2,6,5,1084,0,8,1092,0
73,0,39,600,97,47,0,3,1,1,2,1,3,0,794,0,4,798,0
74,4,105,246,43,227,0,0,3,0,0,3,1,1,633,0,4,637,0
75,2,135,402,121,23,2,2,1,1,0,1,3,0,693,0,3,696,0
76,3,284,371,53,9,0,0,2,2,0,0,3,2,729,0,2,731,0
77,2,48,373,30,435,1,0,1,0,1,4,5,1,901,0,6,907,0
78,2,194,448,62,69,2,0,2,0,0,2,3,1,785,0,1,786,0
79,3,44,604,53,36,0,1,0,0,1,1,2,1,746,0,0,746,0
80,1,196,480,124,9,0,0,8,0,2,1,7,2,830,0,2,832,0
81,3,36,246,17,338,0,1,1,0,1,0,2,0,645,0,0,645,0
82,0,183,391,13,34,0,1,5,1,2,0,3,0,633,0,3,636,0
83,2,151,625,97,107,0,2,2,1,0,2,6,0,995,0,3,998,0
84,0,59,380,124,98,2,1,1,3,0,1,1,3,673,0,4,677,0
85,1,7,214,16,263,0,0,0,0,0,0,0,1,502,0,1,503,0
86,3,120,392,58,438,3,1,3,2,7,3,3,3,1036,0,3,1039,0
87,0,268,409,16,6,0,0,2,0,0,0,2,1,704,0,2,706,0
88,3,66,351,149,128,2,1,1,2,1,1,6,0,711,0,3,714,0
89,2,117,308,36,96,3,0,4,0,0,1,2,1,570,0,0,570,0
90,2,110,390,54,213,0,1,2,1,4,0,1,0,778,0,6,784,0
91,5,202,480,76,106,2,0,3,2,1,1,7,3,888,0,4,892,0
92,2,374,615,82,5,1,0,2,2,1,1,5,1,1091,0,4,1095,0
93,1,271,353,59,5,1,1,2,0,2,1,1,1,698,0,2,700,0
94,1,220,430,66,7,1,0,2,3,0,0,5,3,738,0,5,743,0
95,3,103,339,190,311,3,0,4,4,3,2,4,3,969,0,6,975,0
96,0,185,170,51,71,1,0,0,0,0,1,1,0,480,0,1,481,0
97,0,110,185,25,415,5,0,1,0,1,0,0,1,743,0,3,746,0
98,1,134,331,18,91,1,1,2,0,2,1,2,0,584,0,1,585,0
99,3,325,528,124,23,3,0,8,0,2,4,5,7,1032,0,4,1036,0
100,2,15,205,5,366,3,1,0,0,3,2,1,0,603,0,1,604,0
101,3,7,141,6,367,2,0,0,0,6,2,5,3,542,0,6,548,0
102,2,115,594,87,21,2,1,3,1,1,0,4,1,832,0,6,838,0
103,2,121,355,26,8,0,1,2,0,0,0,3,2,520,0,3,523,0
104,2,175,616,71,13,1,0,4,0,0,1,8,0,891,0,4,895,0
105,1,230,398,14,7,0,0,1,0,0,1,1,2,655,0,5,660,0
106,1,247,261,13,4,0,0,4,0,0,0,0,2,532,0,1,533,0
107,0,31,308,1,393,2,1,0,0,1,0,2,0,739,0,1,740,0
108,4,83,331,263,9,0,0,1,1,1,2,6,0,701,0,7,708,0
109,6,154,386,186,115,2,0,1,1,4,1,8,1,865,0,4,869,0
110,1,229,430,40,7,1,0,4,1,0,1,5,2,721,0,4,725,0
111,2,112,300,61,3,0,1,4,0,1,3,3,0,490,0,2,492,0
112,3,277,341,31,4,1,0,5,1,2,3,4,0,672,0,0,672,0
113,1,60,229,90,613,1,2,2,0,4,7,11,0,1020,0,5,1025,0
114,1,33,114,7,341,0,0,0,0,0,0,1,1,498,0,0,498,0
115,1,42,173,15,438,1,0,1,0,1,0,1,2,675,0,1,676,0
116,6,512,269,273,33,1,1,8,2,1,2,2,2,1112,0,7,1119,0
117,2,328,322,18,4,0,0,4,0,0,0,0,2,680,0,0,680,0
118,2,79,300,244,10,1,2,1,2,1,0,3,0,645,0,4,649,0
119,3,187,347,123,10,2,3,2,1,1,1,2,0,682,0,1,683,0
120,0,161,700,86,48,1,0,5,1,1,1,4,1,1009,0,1,1010,0
121,2,276,518,25,8,1,0,6,1,0,0,1,1,839,0,5,844,0
122,1,411,274,60,242,2,0,9,1,2,0,2,1,1005,0,4,1009,0
123,1,241,463,203,6,0,1,7,3,0,1,4,2,932,0,0,932,0
124,5,49,381,103,27,0,0,1,1,2,1,4,0,574,0,1,575,0
125,0,234,259,21,121,1,1,2,0,1,0,4,1,645,0,3,648,0
126,0,117,412,4,49,1,0,2,0,2,1,2,2,592,0,4,596,0
127,1,430,589,24,62,0,0,11,0,1,1,4,1,1124,0,2,1126,0
128,1,223,366,30,8,0,0,3,0,0,1,5,0,637,0,1,638,0
129,2,228,174,11,3,1,1,6,0,0,0,7,2,435,0,3,438,0
130,4,158,533,25,282,0,4,4,1,2,4,5,1,1023,0,7,1030,0
131,2,120,446,16,33,0,1,4,0,0,0,3,2,627,0,3,630,0
132,2,190,428,81,8,0,0,4,0,2,1,1,2,719,0,1,720,0
133,0,131,297,25,63,0,0,1,0,2,0,0,2,521,0,3,524,0
134,0,181,672,68,12,2,0,3,1,0,2,7,2,950,0,3,953,0
135,1,106,456,80,11,1,1,2,1,1,1,3,1,665,0,2,667,0
136,1,81,450,177,6,0,0,3,2,1,1,6,2,730,0,1,731,0
137,2,191,224,46,7,0,1,9,1,0,0,4,2,487,0,2,489,0
138,3,141,522,92,162,2,2,1,2,6,2,3,1,939,0,4,943,0
139,2,271,358,113,76,2,1,6,0,2,1,8,4,844,0,2,846,0
140,0,83,217,18,13,2,0,3,2,0,1,4,1,344,0,2,346,0
141,3,189,416,82,204,3,1,3,0,2,3,5,1,912,0,2,914,0
142,0,37,183,34,270,0,0,1,0,1,0,4,1,531,0,1,532,0
143,1,143,236,32,238,2,4,4,1,5,0,5,3,674,0,1,675,0
144,2,210,569,19,4,0,0,2,1,1,0,10,1,819,0,3,822,0
145,2,64,314,13,33,2,0,2,0,0,1,5,2,438,0,4,442,0
146,3,84,361,25,79,0,0,2,1,0,0,5,2,562,0,4,566,0
147,3,187,526,15,103,1,0,2,2,0,3,6,1,849,0,1,850,0
148,5,20,174,22,384,3,2,3,2,4,4,15,4,642,0,3,645,0
149,0,38,195,35,195,2,0,0,0,2,0,4,0,471,0,3,474,0
150,1,118,438,54,120,0,0,4,1,3,2,5,2,748,0,12,760,0
151,0,191,293,17,10,0,0,4,2,0,0,3,0,520,0,2,522,0
152,0,66,187,10,130,0,0,1,0,3,0,0,0,397,0,1,398,0
153,2,46,272,10,438,1,1,2,0,1,1,1,0,775,0,7,782,0
154,1,86,224,15,250,1,1,2,1,1,1,6,2,591,0,4,595,0
155,4,29,205,21,391,1,1,1,0,3,4,6,1,667,0,5,672,0
156,2,143,312,91,9,0,0,1,0,1,1,5,2,567,0,2,569,0
157,0,112,251,92,1,0,1,6,0,1,0,4,3,471,0,0,471,0
158,1,110,452,119,30,1,1,1,0,1,3,2,0,721,0,4,725,0
159,1,269,621,59,5,1,0,6,1,2,0,6,3,974,0,4,978,0
160,1,173,474,155,10,0,0,2,1,0,5,2,5,828,0,5,833,0
161,2,165,347,14,3,1,0,2,0,0,0,3,2,539,0,3,542,0
162,1,40,453,59,4,2,1,0,2,1,0,2,0,565,0,0,565,0
163,1,136,549,75,16,0,1,0,2,0,1,9,1,791,0,5,796,0
164,4,207,513,167,26,1,2,2,4,0,1,5,1,933,0,1,934,0
165,1,82,425,7,230,3,1,1,1,0,1,1,1,754,0,1,755,0
166,0,39,247,21,404,1,3,1,1,1,1,3,1,723,0,1,724,0
167,3,55,195,22,804,2,2,2,1,6,0,4,1,1097,0,4,1101,0
168,2,90,274,36,151,0,3,0,0,0,0,0,1,557,0,1,558,0
169,3,120,526,387,19,1,1,3,3,2,3,13,0,1081,0,3,1084,0
170,1,69,322,128,54,1,0,2,0,1,1,1,0,580,0,3,583,0
171,2,41,289,75,91,1,1,0,0,2,4,6,1,513,0,4,517,0
172,1,27,308,178,227,2,1,0,1,4,1,3,0,753,0,2,755,0
173,3,93,540,64,15,0,1,2,3,0,4,5,1,731,0,1,732,0
174,1,75,566,112,34,1,1,0,1,0,1,5,0,797,0,4,801,0
175,1,92,321,45,6,0,0,2,0,1,2,2,2,474,0,1,475,0
176,1,17,110,26,278,0,0,0,0,0,1,0,0,433,0,1,434,0
177,0,218,443,93,32,0,1,3,1,1,1,5,3,801,0,7,808,0
178,5,38,299,75,254,2,0,1,0,2,1,7,1,685,0,1,686,0
179,5,38,214,25,523,4,0,0,0,1,1,1,0,812,0,4,816,0
180,0,168,511,223,109,0,0,2,1,1,1,2,0,1018,0,3,1021,0
181,0,41,198,27,210,1,1,0,1,5,1,0,1,486,0,0,486,0
182,6,175,460,67,87,1,1,0,1,1,0,0,2,801,0,0,801,0
183,1,264,213,20,262,0,0,3,8,1,1,4,4,781,0,7,788,0
184,0,92,264,17,246,1,0,1,0,2,0,3,1,627,0,3,630,0
185,2,8,173,34,684,3,0,1,1,8,0,5,2,921,0,4,925,0
186,1,17,98,7,368,0,0,0,0,4,0,1,1,497,0,1,498,0
187,4,65,418,13,223,2,0,1,0,2,1,5,1,735,0,3,738,0
188,0,126,634,22,147,1,2,0,2,1,1,3,1,940,0,1,941,0
189,1,5,114,27,481,0,1,1,0,6,0,1,0,637,0,1,638,0
190,2,12,114,11,556,3,3,0,1,4,0,1,1,708,0,1,709,0
191,2,5,103,24,370,2,1,0,0,1,0,3,2,513,0,3,516,0
192,0,326,417,13,2,1,2,4,0,0,1,5,1,772,0,6,778,0
193,3,113,427,45,260,1,0,2,0,1,0,2,2,856,0,4,860,0
194,2,232,629,43,22,1,0,5,0,3,4,8,0,949,0,2,951,0
195,1,57,67,17,371,1,0,0,0,0,0,2,0,516,0,3,519,0
196,2,222,291,15,282,3,0,4,0,3,3,5,4,834,0,5,839,0
197,3,306,654,18,13,1,1,4,1,1,0,6,2,1010,0,5,1015,0
198,3,194,551,19,10,2,1,5,0,3,3,6,2,799,0,4,803,0
199,1,165,530,114,220,1,1,1,0,2,3,8,1,1047,0,6,1053,0
200,0,459,441,5,75,1,0,10,1,2,0,6,1,1001,0,5,1006,0
201,0,39,155,42,565,1,0,0,0,2,0,2,1,807,0,4,811,0
202,3,83,529,22,373,1,1,2,0,2,6,11,1,1034,0,5,1039,0
203,2,80,547,31,60,0,0,5,2,0,0,2,2,731,0,0,731,0
204,6,91,720,73,233,2,4,6,1,4,3,6,1,1150,0,2,1152,0
205,4,26,391,14,372,1,0,0,0,2,1,13,2,826,0,8,834,0
206,2,86,573,290,161,0,1,2,0,3,1,4,1,1124,0,3,1127,0
207,0,370,470,130,118,1,0,4,0,0,2,3,4,1102,0,3,1105,0
208,1,156,532,35,346,0,1,4,1,0,0,5,0,1081,0,0,1081,0
209,0,18,104,14,241,0,0,0,0,1,0,3,0,381,0,0,381,0
210,3,99,393,83,254,1,1,1,1,1,0,5,0,842,0,5,847,0
211,1,11,167,12,223,2,0,0,0,1,0,3,0,420,0,0,420,0
212,1,8,145,22,485,3,1,0,0,1,2,6,1,675,0,0,675,0
213,0,17,259,19,200,0,0,1,5,0,1,1,2,505,0,2,507,0
214,2,8,305,18,370,0,0,0,0,2,0,4,1,710,0,2,712,0
215,2,65,453,31,157,0,0,1,0,1,1,8,0,719,0,2,721,0
216,1,81,245,51,132,0,0,1,4,0,3,4,2,524,0,0,524,0
217,2,22,344,22,661,3,0,1,0,3,4,3,2,1067,0,1,1068,0
218,1,1,193,10,530,0,0,0,0,4,0,3,1,743,0,2,745,0
219,0,89,612,9,131,0,0,1,0,1,0,1,0,844,0,1,845,0
220,0,71,314,13,9,0,0,3,0,0,0,0,0,410,0,0,410,0
221,0,189,254,28,199,0,0,2,0,1,2,2,4,681,0,3,684,0
222,1,10,51,79,247,1,0,0,0,1,0,0,0,390,0,0,390,0
223,1,151,274,10,448,3,0,3,2,3,0,1,3,899,0,1,900,0
224,3,15,369,131,239,0,0,0,4,1,1,9,0,772,0,2,774,0
225,1,77,470,61,448,4,1,5,3,9,5,7,2,1093,0,2,1095,0
226,1,5,201,20,358,1,0,3,1,1,1,5,1,598,0,0,598,0
227,1,16,282,19,552,1,0,1,3,3,0,9,0,887,0,6,893,0
228,3,71,308,38,207,1,0,3,3,4,2,5,0,645,0,2,647,0
229,0,15,331,20,567,3,2,0,0,3,0,3,2,946,0,1,947,0
230,1,38,227,7,169,0,1,0,0,2,0,7,3,455,0,2,457,0
231,0,77,390,11,363,2,0,6,0,3,3,8,2,865,0,0,865,0
232,2,177,329,48,188,3,0,0,0,1,0,13,3,764,0,3,767,0
233,1,205,384,45,120,0,0,2,0,1,1,12,1,772,0,3,775,0
234,0,64,243,20,401,1,1,0,0,1,0,2,2,735,0,4,739,0
235,0,113,427,23,280,4,0,2,0,1,1,3,1,855,0,6,861,0
236,1,103,411,9,138,1,0,2,0,1,3,2,0,671,0,3,674,0
237,3,55,241,12,366,2,0,0,0,2,0,3,0,684,0,6,690,0
238,2,116,444,61,90,1,2,3,0,0,1,5,0,725,0,2,727,0
239,4,54,171,26,281,0,1,2,0,1,0,7,2,549,0,2,551,0
240,2,18,127,6,340,2,1,0,1,4,4,5,1,511,0,0,511,0
241,1,37,151,10,403,3,1,1,2,5,1,7,1,623,0,2,625,0
242,2,74,184,49,414,4,2,2,2,6,2,5,3,749,0,7,756,0
243,5,24,459,22,509,3,2,1,0,2,4,6,3,1040,0,4,1044,0
244,2,39,489,15,343,2,1,0,1,0,1,2,0,895,0,3,898,0
245,0,187,610,21,29,1,1,5,0,0,4,6,4,868,0,4,872,0
246,2,271,554,28,31,0,4,4,0,2,1,13,4,914,0,7,921,0
247,1,92,205,21,599,7,0,5,1,11,2,6,2,952,0,6,958,0
248,5,31,138,35,713,0,0,4,3,3,4,4,1,941,0,5,946,0
249,0,123,348,58,359,3,2,5,1,7,5,6,1,918,0,8,926,0
250,1,11,181,12,720,0,1,1,2,7,2,5,0,943,0,5,948,0
251,3,119,187,28,309,2,0,5,0,1,1,3,0,658,0,2,660,0
252,2,111,172,37,282,0,1,1,0,3,1,3,2,615,0,4,619,0
253,5,224,383,65,359,2,3,7,1,7,4,8,4,1072,0,5,1077,0
254,1,53,248,71,247,1,0,0,2,1,0,2,0,626,0,4,630,0
255,0,17,123,64,337,1,1,0,2,4,1,3,0,553,0,0,553,0
256,5,89,532,219,73,3,1,2,0,0,6,8,4,942,0,8,950,0
257,1,246,526,23,38,4,1,2,2,1,0,1,2,847,0,4,851,0
258,5,308,613,29,90,1,1,4,0,1,1,10,2,1065,0,7,1072,0
259,2,263,449,22,12,2,0,6,2,1,0,3,5,767,0,6,773,0
260,1,163,509,29,99,2,0,1,0,0,1,15,0,820,0,2,822,0
261,2,232,333,18,11,0,0,1,0,0,0,8,1,606,0,2,608,0
262,2,94,231,32,462,1,0,1,1,3,2,13,1,843,0,7,850,0
263,6,55,326,17,323,1,2,3,1,2,0,11,2,749,0,3,752,0
264,1,19,255,10,474,2,1,1,1,8,2,3,1,778,0,4,782,0
265,1,182,502,47,310,1,2,6,3,3,4,19,5,1085,0,13,1098,0
266,5,16,259,21,483,1,1,1,1,3,3,3,2,799,0,4,803,0
267,1,126,510,13,32,0,0,0,0,0,0,4,2,688,0,2,690,0
268,3,85,578,17,10,0,0,3,0,1,1,7,0,705,0,3,708,0
269,0,96,522,25,50,1,1,1,0,1,2,11,0,710,0,2,712,0
270,1,241,506,38,3,0,0,5,0,1,1,7,1,804,0,4,808,0
4,1,3,154,11,354,2,2,1,1,5,0,2,1,537,0,1,538,0
11,3,25,390,65,41,0,0,0,0,0,0,5,1,530,0,2,532,0
27,2,24,606,17,54,1,0,0,0,2,0,1,2,709,0,4,713,0
1,3,29,313,18,3,0,0,0,2,0,1,7,1,377,0,1,378,0
2,0,114,216,9,4,1,0,0,5,0,1,2,0,351,0,0,351,0
3,2,17,813,16,6,0,0,1,0,0,1,7,0,863,0,1,864,0
4,6,54,731,42,9,1,1,2,2,0,2,17,1,868,0,2,870,0
5,5,25,995,13,8,1,2,2,2,0,1,5,1,1060,0,3,1063,0
6,2,33,705,24,10,3,1,0,3,0,2,8,0,791,0,3,794,0
7,1,23,405,5,3,0,0,0,1,0,0,0,0,438,0,2,440,0
        S,0,3.9,443,22,4,0,0,0,0,0,0,3,0,491,0,2,493,0
9,5,15,651,26,6,0,0,2,0,1,0,5,2,713,0,2,715,0
10,4,24,1045,70,14,1,3,5,3,2,9,13,3,1196,0,15,1211,0
11,1,3,666,6,4,0,0,0,1,0,1,2,0,684,0,1,685,0
12,1,8,535,10,4,0,0,1,1,2,1,4,0,567,0,5,572,0
13,3,7,838,18,3,1,0,0,1,1,2,16,0,890,0,6,896,0
          Id,0,1,713,4,3,0,0,0,0,0,0,3,0,724,0,0,724,0
15,0,18,727,115,46,2,4,2,4,2,2,17,0,939,0,10,949,0
16,1,19,426,12,4,1,0,0,0,1,1,5,2,472,0,4,476,0
17,4,82,770,59,9,1,1,2,0,4,3,12,5,952,0,5,957,0
18,2,10,755,21,2,1,0,0,2,0,2,5,3,803,0,7,810,0
19,11,10,231,56,403,3,0,1,1,6,6,10,5,743,0,10,753,0
20,1,19,664,34,7,0,2,0,0,0,1,8,1,737,0,3,740,0
21,0,5,260,22,4,0,0,0,0,0,2,3,0,296,0,3,299,0
22,4,6,699,27,121,0,0,1,1,3,3,13,2,880,0,6,886,0
23,6,14,790,77,30,0,0,0,2,0,2,5,2,928,0,6,934,0
24,8,19,587,22,142,1,0,1,6,4,3,18,9,820,0,13,833,0
25,0,9,655,105,5,0,0,1,0,1,3,6,1,786,0,1,787,0
26,4,6,307,17,311,4,0,0,3,2,7,11,3,675,0,4,679,0
27,1,28,539,83,12,1,0,0,2,2,3,6,2,679,0,4,683,0
28,1,34,469,25,0,0,1,0,0,0,1,3,         Q,534,0,2,536,0
29,0,4,503,6,3,0,0,0,0,0,1,1,0,518,0,1,519,0
30,0,3,507,13,7,0,0,0,0,1,0,2,0,533,0,2,535,0
31,3,29,564,108,85,1,1,0,0,2,3,2,2,800,0,5,805,0
32,1,30,667,27,8,0,1,0,2,3,2,1,0,742,0,1,743,0
33,6,133,643,54,92,1,2,1,1,6,3,11,2,955,0,5,960,0
34,5,53,385,83,43,0,0,3,1,1,3,2,1,580,0,1,581,0
35,3,15,497,13,96,0,1,0,2,2,0,3,0,632,0,6,638,0
36,3,33,868,43,32,1,2,1,1,0,0,5,4,993,0,4,997,0
37,1,5,380,3,29,0,0,0,0,0,0,2,1,421,0,1,422,0
38,0,10,576,12,23,1,0,0,1,0,1,3,1,628,0,1,629,0
39,1,29,462,25,57,0,0,0,0,0,1,3,1,579,0,4,583,0
40,3,12,800,16,109,2,0,0,0,2,2,4,0,950,0,5,955,0
41,,15,522,28,421,0,1,2,4,6,7,17,0,1027,0,5,1032,0
42,2,19,731,36,5,0,0,2,2,1,2,7,3,810,0,0,818,0
43,1,16,732,23,8,0,1,0,0,0,2,2,1,786,0,1,787,0
44,2,23,785,8,10,0,0,1,1,0,0,5,0,835,0,1,836,0
45,0,21,446,4,2,0,0,0,0,0,1,0,1,475,0,0,475,0
46,3,13,788,27,9,0,0,1,0,0,0,8,0,849,0,3,852,0
47,3,101,560,74,6,3,1,2,0,0,1,9,3,763,0,1,764,0
48,1,63,538,95,7,1,0,2,0,2,0,8,0,717,0,3,720,0
49,3,61,515,24,5,1,1,0,1,1,0,7,1,620,0,2,622,0
50,2,22,929,30,7,0,0,0,0,0,0,4,0,994,0,1,995,0
51,3,7,859,9,28,0,0,3,0,0,0,9,0,918,0,4,922,0
52,1,3,556,6,3,1,0,0,0,0,0,0,0,570,0,0,570,0
53,1,0,617,10,55,0,0,0,0,0,1,9,1,694,0,1,695,0
54,3,59,593,60,6,0,0,0,8,0,0,2,0,731,0,5,736,0
55,7,80,542,131,18,1,6,1,13,2,2,7,3,813,0,6,819,0
56,2,9,427,27,494,2,2,2,2,8,3,11,1,990,0,5,995,0
57,1,36,638,28,7,0,0,0,3,1,0,6,2,722,0,4,726,0
58,3,43,432,17,39,0,0,1,1,2,0,11,2,551,0,5,556,0
59,0,19,545,9,3,0,0,0,0,0,0,1,0,577,0,3,580,0
60,7,19,460,38,290,3,1,0,1,12,8,21,5,865,0,7,872,0
61,4,13,492,70,88,2,1,0,141,4,2,14,1,832,0,1,833,0
62,1,22,427,62,22,3,0,6,260,0,3,17,1,824,0,3,827,0
63,4,45,601,90,200,3,1,0,17,0,4,5,1,972,0,5,977,0
64,3,57,973,118,11,1,1,1,5,0,4,8,0,1182,0,9,1191,0
65,3,46,971,96,14,1,0,1,1,2,3,11,1,1150,0,7,1157,0
66,2,10,553,52,174,1,0,0,0,3,4,26,3,828,0,6,834,0
67,1,4,89,35,186,0,0,0,1,0,3,2,1,322,0,4,326,0
68,4,14,373,46,199,1,0,0,1,0,0,1,1,640,0,2,642,0
69,1,5,617,19,1,0,0,0,0,0,0,0,0,643,0,0,643,0
70,3,38,704,25,8,0,0,2,1,0,2,8,4,795,0,7,802,0
71,5,20,870,62,100,1,1,1,0,6,4,10,5,1085,0,10,1095,0
72,14,57,821,122,61,0,0,4,6,2,6,14,4,1111,0,7,1118,0
73,7,63,675,72,13,0,1,1,3,4,1,16,5,861,0,19,880,0
74,1,21,676,82,11,2,0,0,2,0,2,6,3,306,0,3,809,0
75,0,11,293,25,104,1,1,0,0,0,0,7,3,445,0,6,451,0
76,2,12,589,39,7,0,0,1,2,0,3,3,2,660,0,3,663,0
77,1,29,793,83,17,1,0,1,1,0,5,16,5,952,0,15,967,0
78,0,12,637,15,1,0,0,0,2,1,0,5,1,674,0,3,677,0
79,2,19,559,23,11,0,2,1,1,1,1,12,3,635,0,1,636,0
80,1,16,526,28,77,1,1,0,2,2,2,5,0,661,0,5,666,0
81,0,20,588,28,12,0,0,0,1,2,1,6,1,659,0,2,661,0
82,3,38,628,83,7,0,1,0,1,1,2,21,1,786,0,5,791,0
83,7,38,524,57,59,0,1,1,2,1,3,6,1,700,0,6,706,0
84,11,4,399,9,339,0,2,0,3,2,6,14,3,792,0,8,800,0
85,1,24,418,32,63,2,0,0,0,0,1,2,1,544,0,3,547,0
86,2,130,655,119,17,1,0,1,0,1,3,7,4,940,0,11,951,0
87,2,86,613,49,11,0,0,0,1,0,0,5,1,768,0,3,771,0
88,6,49,586,71,3,0,0,0,0,1,1,23,1,741,0,8,749,0
89,0,9,309,32,73,0,1,0,1,1,3,7,2,438,0,3,441,0
90,1,29,640,30,21,0,0,0,1,0,0,3,0,725,0,1,726,0
91,3,38,658,37,3,0,0,0,0,0,5,7,3,754,0,7,761,0
92,3,10,236,30,3,1,0,0,0,1,1,3,0,288,0,2,290,0
93,2,11,386,39,115,2,4,0,2,3,2,9,3,578,0,5,583,0
94,3,50,494,73,12,0,2,1,0,1,3,3,1,653,0,5,658,0
95,4,7,748,20,239,0,0,2,2,2,2,13,1,1040,0,4,1044,0
96,4,118,623,37,12,4,2,2,1,2,3,19,4,831,0,8,839,0
97,2,93,527,52,6,1,0,6,1,0,1,10,2,701,0,1,702,0
98,1,19,510,30,122,0,1,0,1,0,2,17,3,706,0,8,714,0
99,3,12,393,34,22,0,1,0,1,1,0,11,1,479,0,6,485,0
100,11,4,516,8,40,1,0,1,0,1,4,27,1,614,0,7,621,0
101,2,4,810,10,40,1,0,0,0,4,3,29,1,904,0,8,912,0
102,6,15,868,15,17,5,4,3,4,4,6,24,11,982,0,9,991,0
103,1,2,577,6,24,1,0,0,0,0,0,8,2,621,0,3,624,0
104,3,3,520,5,116,1,0,0,1,1,0,4,1,655,0,3,658,0
105,9,5,457,15,323,4,0,2,4,3,7,9,12,850,0,11,861,0
106,2,3,503,23,256,0,2,0,3,1,2,14,2,811,0,9,820,0
107,0,5,723,9,2,0,0,0,0,0,1,1,0,741,0,1,742,0
108,0,7,512,13,3,0,0,0,0,0,1,1,0,537,0,0,537,0
109,2,28,530,104,90,1,2,4,2,4,3,10,5,785,0,10,795,0
110,2,17,448,47,7,3,0,0,0,0,2,3,1,530,0,1,531,0
111,6,7,589,41,16,1,1,1,0,0,4,7,0,673,0,9,682,0
112,2,16,425,30,346,2,1,0,1,0,2,6,2,833,0,7,840,0
113,0,26,830,25,191,2,1,0,2,3,1,3,1,1085,0,4,1089,0
114,0,82,209,24,148,2,0,2,1,0,0,2,3,473,0,2,475,0
115,3,92,528,75,318,6,0,0,1,9,1,11,0,1044,0,8,1052,0
116,1,10,90,77,822,0,0,0,0,4,0,0,0,1004,0,2,1006,0
117,0,13,170,19,442,3,2,1,0,2,1,2,1,656,0,3,659,0
118,10,5,64,122,380,3,1,2,3,4,2,3,1,600,0,3,603,0
119,1,42,405,15,372,0,1,1,1,5,0,3,0,846,0,4,850,0
120,1,80,1035,42,12,1,2,1,0,1,2,4,1,1182,0,6,1188,0
121,1,4,398,14,121,2,0,1,0,1,1,6,2,551,0,0,551,0
122,0,45,653,34,19,2,1,2,3,0,0,3,1,763,0,4,767,0
123,4,62,628,18,214,1,1,1,2,0,0,6,2,939,0,3,942,0
124,2,34,499,21,516,1,4,4,1,8,1,11,6,1108,0,3,1111,0
125,4,63,453,19,115,2,1,0,0,2,2,4,0,665,0,2,667,0
126,3,60,672,24,12,0,2,1,0,0,2,6,1,783,0,6,789,0
127,1,55,381,103,16,1,2,1,2,0,2,5,0,569,0,3,572,0
128,0,2,206,16,176,1,2,0,0,2,3,2,3,413,0,4,417,0
129,2,46,371,127,43,0,0,1,3,1,3,1,1,599,0,3,602,0
130,1,26,195,108,303,2,3,3,0,3,2,2,3,651,0,3,654,0
131,2,4,176,27,485,3,1,2,0,9,2,1,1,713,0,3,716,0
132,4,47,268,72,97,1,1,0,0,0,0,0,0,490,0,2,492,0
133,2,100,520,       ISO,69,1,2,1,2,3,7,7,1,865,0,4,869,0
134,2,79,242,54,554,8,2,4,6,10,7,11,3,982,0,7,989,0
135,0,134,401,117,18,0,0,1,1,0,2,6,2,682,0,0,682,0
136,0,18,316,75,135,2,1,0,0,1,0,3,0,551,0,2,553,0
137,1,195,295,85,40,0,1,2,0,4,3,3,3,632,0,7,639,0
138,3,119,416,58,3,0,2,1,2,0,1,4,1,610,0,5,615,0
139,2,149,751,120,16,1,1,2,3,2,4,19,5,1075,0,5,1080,0
140,8,68,406,24,421,1,2,0,1,8,0,3,4,946,0,6,952,0
141,7,90,412,13,61,0,1,2,1,0,2,2,2,593,0,7,600,0
142,1,3,435,8,126,0,3,0,1,1,3,17,3,651,0,14,665,0
143,4,104,433,26,131,3,0,1,3,3,3,12,3,726,0,8,734,0
144,2,113,405,18,9,0,0,4,1,0,2,5,2,561,0,4,565,0
145,5,112,397,145,67,0,1,2,4,1,2,3,4,743,0,5,748,0
146,2,1,162,21,286,4,1,0,2,3,4,9,5,500,0,15,515,0
147,2,155,364,216,7,0,1,2,5,2,2,3,2,761,0,4,765,0
148,2,197,391,41,7,0,0,2,1,1,3,5,2,652,0,2,654,0
149,5,287,506,65,9,3,0,3,2,0,2,3,3,888,0,3,891,0
150,1,264,462,25,281,3,0,4,0,2,4,4,6,1056,0,6,1062,0
151,3,208,423,61,42,4,0,7,5,5,4,7,1,770,0,7,777,0
152,3,174,361,80,8,1,1,5,2,5,2,8,4,654,0,3,657,0
153,2,133,451,38,34,0,0,4,0,0,1,7,2,672,0,2,674,0
154,3,241,602,37,84,0,2,2,3,0,3,13,4,994,0,7,1001,0
155,5,90,618,           8S,37,1,0,2,3,2,2,4,3,852,0,8,860,0
156,            S,51,449,85,424,4,0,1,3,5,5,9,5,1049,0,6,1056,0
157,1,61,232,21,72,1,1,1,0,1,2,2,4,449,0,8,455,0
158,4,59,389,35,11,0,0,1,1,0,4,7,0,511,0,2,513,0
159,1,          lis,386,46,11,1,2,3,1,2,1,2,3,577,0,0,577,0
160,3,126,736,102,95,6,1,6,4,8,1,7,3,1098,0,9,1107,0
161,1,82,676,148,77,0,0,1,2,1,2,9,2,1001,0,1,1002,0
162,3,50,376,49,192,4,0,2,0,1,4,7,0,688,0,2,690,0
163,11,72,346,42,469,6,3,4,3,4,2,16,4,982,0,9,991,0
164,2,51,363,25,290,9,0,0,2,5,1,15,4,767,0,5,772,0
165,3,       lie,515,85,164,3,0,8,2,4,3,13,3,921,0,7,928,0
166,4,124,138,9,275,0,1,1,0,4,2,3,2,563,0,5,568,0
167,4,130,      4ai,22,          ISO,7,1,9,7,5,2,5,2,855,0,1,856,0
168,0,41,606,11,16,0,0,0,1,1,0,1,0,677,0,3,680,0
169,2,81,456,212,74,1,2,2,0,2,9,10,2,853,0,6,859,0
170,2,61,567,45,266,1,0,1,2,4,3,5,7,964,0,5,969,0
171,3,187,535,46,80,1,0,4,1,1,2,8,0,868,0,1,869,0
172,6,83,417,77,419,3,1,1,2,6,0,8,1,1024,0,8,1032,0
173,2,227,356,101,179,0,0,1,1,3,0,8,2,880,0,5,885,0
174,1,138,500,63,58,1,0,0,0,0,0,1,0,762,0,2,764,0
175,1,28,337,55,573,4,0,2,2,7,3,5,1,1018,0,6,1024,1
176,5,235,695,81,8,1,0,3,2,1,4,5,3,1043,0,5,1048,0
177,3,127,786,86,86,1,3,5,0,0,2,6,0,1105,0,3,1108,0
178,6,145,376,17,164,1,0,6,0,2,1,4,5,727,0,2,729,0
179,3,171,386,4,2,0,0,1,0,1,1,2,1,572,0,1,573,0
180,3,188,673,25,12,1,1,6,0,2,1,5,2,919,0,5,924,0
181,0,126,332,17,8,0,0,0,2,1,1,0,1,488,0,4,492,0
182,6,410,438,16,10,1,4,6,0,2,2,3,5,903,0,6,909,0
183,0,109,582,36,46,0,1,1,1,0,0,6,1,783,0,4,787,0
184,0,236,560,68,10,0,2,2,1,0,2,7,2,890,0,1,891,0
185,4,302,584,71,153,4,0,12,3,3,2,7,7,1152,0,6,1158,0
186,3,133,632,41,134,2,1,4,1,4,2,6,3,966,0,3,969,0
187,2,281,505,163,12,4,1,5,2,3,4,4,3,989,0,6,995,0
188,2,20,158,8,279,4,1,2,1,3,4,7,2,491,0,2,493,0
189,3,96,530,40,7,1,0,1,1,1,4,9,0,693,0,3,696,0
190,1,108,595,97,13,1,1,2,1,0,2,10,2,833,0,9,842,0
191,2,98,884,56,18,1,0,2,0,1,1,2,0,1065,0,9,1074,0
192,0,71,879,25,7,0,0,2,0,0,1,15,3,1003,0,7,1010,0
193,3,200,413,23,12,0,0,3,0,1,2,4,4,665,0,1,666,0
194,7,27,330,24,440,3,0,0,2,1,2,5,4,845,0,10,855,0
195,3,176,486,37,11,1,0,1,1,0,1,3,0,720,0,1,721,0
196,3,95,422,234,7,1,0,0,2,0,1,5,0,770,0,3,773,0
197,1,54,293,108,167,3,0,0,2,1,3,5,2,639,0,3,642,0
198,2,35,568,67,6,3,0,1,0,2,0,6,3,693,0,8,701,0
199,3,32,474,58,236,3,6,6,8,5,7,19,13,870,0,18,868,0
200,7,205,528,58,307,4,1,5,5,1,7,8,6,1142,0,12,1154,0
201,5,159,300,64,243,2,0,1,2,4,1,6,2,789,0,6,795,0
202,1,191,294,29,70,2,0,0,4,0,4,4,3,602,0,9,611,0
203,13,9,844,17,179,3,0,2,1,2,2,27,4,1103,0,21,1124,0
204,8,122,553,52,154,1,2,5,3,2,4,24,14,944,0,15,959,0
205,5,136,570,97,169,2,2,4,2,4,4,6,4,1005,0,5,1010,0
206,2,256,665,52,12,2,0,7,2,1,1,15,4,1019,0,3,1022,0
207,0,174,896,31,89,1,0,4,0,4,4,11,3,1217,0,12,1229,0
208,5,135,447,55,27,0,0,2,1,0,0,2,1,675,0,4,679,0
209,3,114,460,39,13,1,0,1,0,0,3,4,2,640,0,4,644,1
210,1,25,215,34,588,1,0,0,0,3,1,2,1,871,0,7,878,0
211,4,273,397,38,31,1,0,4,0,3,3,5,0,769,0,5,764,0
212,1,282,361,33,31,0,0,7,1,4,3,3,0,726,0,10,736,0
213,0,5,477,7,10,0,1,1,1,1,1,13,1,518,0,        S,528,0
214,10,17,447,30,309,3,0,0,0,4,2,10,5,837,0,13,850,0
215,2,20,149,50,698,1,0,"         1,",3,1,2,1,0,928,0,7,935,0
216,7,75,551,40,198,4,1,4,1,4,2,7,3,897,0,4,901,0
217,14,33,440,53,561,1,1,0,0,0,4,4,5,1116,0,13,1129,0
218,2,38,516,35,276,7,3,1,0,4,3,10,3,898,0,6,904,0
219,2,17,69,10,472,8,1,0,         I,4,3,5,1,593,0,3,596,0
220,3,41,229,23,289,2,0,3,0,5,0,6,4,605,0,3,608,0
221,7,36,349,11,164,4,0,0,2,5,7,23,4,612,0,10,622,0
222,4,40,725,26,90,2,0,0,0,1,2,10,1,901,0,4,905,0
223,1,14,264,18,281,0,0,0,1,0,0,4,2,585,0,1,586,0
224,9,105,654,164,172,3,2,1,2,6,17,22,6,1163,0,5,1168,0
225,4,53,805,21,8,1,0,0,1,1,6,13,3,916,0,9,925,0
227,1,84,275,18,9,0,0,2,1,0,1,2,2,395,0,5,400,0
228,1,        A,206,4,342,3,0,0,2,1,1,2,3,569,0,3,572,0
229,5,7,419,21,408,4,1,1,0,5,3,4,2,880,0,11,891,0
230,6,2,297,24,436,8,8,2,1,11,6,12,11,824,0,20,844,0
231,0,2,238,16,496,3,1,0,0,4,1,2,3,766,0,4,770,0
232,3,18,420,19,427,5,1,0,0,8,3,2,2,908,0,2,910,0
233,2,111,349,16,13,1,0,1,0,3,4,0,2,502,0,6,508,0
234,3,105,575,12,8,0,2,0,0,0,1,4,1,711,0,5,716,0
235,4,11,141,18,267,4,3,0,1,1,2,0,7,459,0,5,464,0
236,3,9,187,24,361,4,2,1,1,4,2,2,2,602,0,5,607,0
237,2,70,388,18,107,1,5,2,4,2,2,3,2,606,0,6,612,0
238,4,8,156,12,289,4,3,0,2,4,4,4,2,492,0,2,494,0
239,9,6,342,29,548,4,1,6,4,3,5,4,6,967,0,14,981,0
240,4,215,438,37,77,0,1,9,2,1,2,4,5,795,0,5,800,0
241,4,76,581,40,48,3,3,2,2,5,1,8,4,777,0,16,793,0
242,7,13,344,13,419,2,0,2,2,9,0,16,6,833,0,9,842,0
243,8,6,130,23,400,7,3,3,7,9,5,12,4,617,0,15,632,0
244,1,1,78,9,319,1,0,0,2,0,1,1,1,414,0,3,417,0
245,3,3,114,20,522,1,0,0,0,2,0,2,2,669,0,2,671,0
246,3,9,155,24,472,1,1,1,0,3,0,2,0,671,0,2,673,0
247,1,79,308,38,250,1,0,0,0,3,0,0,1,681,0,1,682,0
248,0,32,197,45,433,2,1,1,3,4,3,12,4,737,0,5,742,0
249,2,3,92,7,622,6,0,1,2,9,1,2,1,748,0,8,756,0
250,0,4,93,17,519,0,0,0,0,0,0,1,0,634,0,5,639,0
251,3,7,304,28,405,5,3,0,3,4,3,15,6,786,0,11,797,0
252,5,2,104,17,654,1,1,2,3,7,3,10,3,812,0,4,816,0
253,2,11,123,92,162,1,0,2,1,1,2,0,2,399,0,4,403,0
254,10,118,706,68,28,5,0,3,1,1,5,13,9,967,0,12,979,0
255,2,142,529,45,23,1,0,2,1,1,0,2,0,753,0,1,754,0
256,6,         S,217,18,253,9,2,0,5,3,4,2,10,534,0,15,549,0
257,12,4,309,27,265,7,1,2,-1,3,8,12,9,660,0,17,677,0
258,10,10,337,27,283,9,2,3,3,7,9,16,8,724,0,14,738,0
259,6,21,        2T1,34,288,3,2,0,3,7,6,9,14,663,0,15,678,0
260,6,128,657,71,177,2,1,5,4,1,5,8,5,1070,0,7,1077,0
261,2,        i07,477,30,84,2,1,5,0,2,2,7,0,719,0,1,720,0
262,10,1,283,6,238,1,1,0,2,1,4,9,6,562,0,8,570,0
263,1,26,321,56,319,0,0,1,2,1,0,2,0,729,0,4,733,0
264,1,145,429,38,22,1,0,1,0,1,0,10,4,652,0,1,653,0
265,1,175,732,46,2,0,1,1,0,0,1,14,2,975,0,1,976,0
266,3,154,781,13,6,1,0,1,0,3,1,5,6,974,0,5,979,0
267,7,198,775,23,15,1,0,5,0,2,2,13,2,1043,0,7,1050,0
268,0,50,502,41,4,0,0,0,1,1,0,             A,2,605,0,1,606,0
269,7,37,404,12,25,1,0,0,0,3,0,4,2,495,0,3,498,0
270,2,32,761,18,6,0,0,1,1,0,2,5,3,831,0,1,832,0
271,1,49,678,10,6,0,2,1,0,0,0,10,3,760,0,0,760,0
272,6,63,545,10,101,0,2,2,3,0,5,12,7,756,0,11,767,0
273,1,10,265,4,68,0,1,0,1,1,4,14,0,369,0,2,371,0
1,7,157,402,50,9,3,0,2,1,0,1,5,2,639,0,3,642,0
2,2,100,738,54,35,1,0,2,0,1,0,2,2,937,0,0,937,0
3,2,88,470,40,41,2,1,0,2,1,3,8,6,664,0,2,666,0
4,1,28,764,31,158,1,3,2,0,1,3,3,4,999,0,7,1006,0
5,3,48,335,7,28,2,0,2,2,2,4,7,2,442,0,4,446,0
6,1,47,332,34,91,2,0,0,1,1,1,11,4,525,0,8,533,0
7,1,66,628,13,22,1,0,1,0,1,3,8,2,746,0,5,751,0
8,9,177,591,54,197,4,2,3,1,4,3,2,8,1055,0,6,1061,0
9,1,126,794,17,8,1,0,1,1,3,7,6,1,966,0,6,972,0
10,0,3,389,6,70,0,0,0,0,0,0,0,1,469,0,1,470,0
11,3,82,771,80,16,1,1,0,1,1,4,7,3,970,0,3,973,0
12,7,99,585,37,3,3,2,0,0,2,1,1,1,741,0,0,741,0
13,2,41,349,71,3,0,3,4,0,1,3,6,1,484,0,3,487,0
14,4,132,731,23,13,1,0,3,1,1,1,7,3,920,0,3,923,0
15,0,52,682,16,14,0,1,0,1,2,0,11,3,782,0,5,787,0
16,3,63,596,15,10,0,0,0,0,1,0,9,1,698,0,4,702,0
17,3,67,678,34,10,1,1,0,0,0,0,9,0,803,0,4,807,0
18,1,163,484,66,15,2,0,6,3,1,4,5,5,755,0,2,757,0
19,5,163,396,37,9,4,0,1,0,4,2,7,0,628,0,5,633,0
20,2,18,774,25,5,0,0,0,0,3,2,2,0,831,0,3,834,0
21,1,154,501,25,10,0,0,2,1,0,0,2,0,696,0,2,698,0
22,6,37,427,45,266,2,3,1,4,3,1,6,4,805,0,2,807,0
23,2,37,460,70,331,3,1,1,1,6,2,9,4,927,0,6,933,0
24,8,94,556,90,334,4,0,2,3,9,3,14,4,1121,0,7,1128,0
25,1,32,336,15,42,2,0,1,0,0,0,3,1,433,0,5,438,0
26,2,30,741,31,10,1,1,1,0,0,0,4,2,823,0,0,823,0
27,0,13,386,43,14,0,2,0,0,0,0,1,0,459,0,1,460,0
28,12,39,322,48,581,10,4,8,3,23,8,25,10,1093,0,24,1117,0
29,1,40,274,384,21,6,3,1,7,1,2,1,0,741,0,7,748,0
30,4,55,682,169,19,0,5,1,0,4,1,12,2,954,0,4,958,0
31,6,26,471,143,30,0,18,5,6,7,7,16,3,738,0,10,748,0
32,7,57,547,128,196,1,3,0,3,5,4,14,2,967,0,4,971,0
33,1,15,235,10,153,3,1,1,4,1,1,4,1,430,0,4,434,0
34,5,154,546,65,47,0,2,5,0,2,4,10,3,843,0,4,847,0
35,6,129,520,255,75,4,2,3,3,6,0,5,3,1011,0,5,1016,0
36,7,25,493,95,210,5,3,4,3,1,5,7,6,864,0,6,870,0
37,7,28,648,80,12,1,0,3,5,1,1,9,0,795,0,3,798,0
38,6,1,149,21,396,5,1,1,1,1,3,5,4,594,0,5,599,0
39,4,4,249,22,586,6,3,0,2,7,5,13,5,906,0,9,915,0
40,3,12,532,464,85,3,2,2,3,2,6,4,2,1120,0,8,1128,0
41,3,38,430,311,270,4,3,0,3,3,2,8,4,1079,0,5,1084,0
42,2,3,137,86,326,3,0,0,1,3,0,2,1,564,0,0,568,0
43,9,304,577,51,13,5,0,1,2,4,2,4,4,976,0,12,983,0
44,3,117,471,27,15,0,0,3,1,1,2,14,7,661,0,7,663,0
45,1,104,523,54,82,2,0,3,1,2,5,10,8,795,0,13,808,0
46,11,132,623,43,129,3,1,3,0,1,3,3,2,954,0,13,967,0
47,4,230,570,43,20,2,2,2,3,2,7,15,1,901,0,10,911,0
48,2,149,701,35,20,7,1,6,2,4,4,21,7,959,0,23,982,0
49,6,290,360,56,18,1,2,16,3,4,5,8,7,776,0,7,783,0
50,4,26,441,11,53,0,1,0,1,1,1,7,2,548,0,3,551,0
51,4,122,749,74,12,1,1,1,2,3,4,8,2,983,0,11,994,0
52,1,39,568,299,12,0,3,0,3,2,1,10,1,939,0,3,942,0
53,5,50,594,64,30,2,2,2,2,3,1,9,4,768,0,11,779,0
54,3,6,368,28,73,1,1,0,2,1,2,10,5,500,0,4,504,0
55,8,7,379,49,356,2,3,2,2,8,3,7,5,831,0,6,837,0
56,9,16,547,71,242,2,1,1,1,8,0,12,2,912,0,5,917,1
57,                  g,23,723,96,45,1,0,0,0,4,0,5,3,909,0,3,912,0
58,6,5,231,35,279,4,2,3,4,8,11,14,10,612,0,11,623,0
59,4,7,191,19,400,2,2,1,0,3,1,5,3,638,0,4,642,0
60,3,3,170,7,366,1,0,1,0,9,2,3,1,566,0,6,572,0
61,6,8,325,30,576,4,1,0,2,7,0,6,8,973,0,9,982,0
62,8,3,408,28,582,5,0,1,3,4,4,3,9,1058,0,14,1072,0
63,10,6,375,29,337,7,3,0,2,6,2,10,1,788,0,6,794,0
64,4,8,441,33,429,3,1,1,0,3,6,1,5,935,0,3,938,0
65,4,6,273,27,707,3,2,2,2,10,2,9,4,1051,0,18,1069,0
66,14,5,318,10,358,3,1,0,4,10,6,12,8,749,0,8,757,0
67,1,6,1000,18,10,0,0,1,0,0,1,0,2,1039,0,1,1040,0
68,1,5,473,14,1,0,0,0,0,0,0,0,3,497,0,0,497,0
69,3,10,637,59,42,4,0,2,1,3,3,11,4,779,0,3,782,0
70,5,10,580,83,296,2,1,3,6,7,14,12,8,1027,0,24,1051,0
85,6,22,526,25,132,3,2,0,0,2,2,7,1,728,0,6,734,0
86,11,8,286,67,496,8,3,2,1,10,3,8,12,915,0,25,940,0
87,3,5,323,37,475,2,0,0,1,5,2,4,2,859,0,2,861,0
88,4,13,565,64,401,1,0,0,1,2,2,12,3,1068,0,7,1075,0
89,3,20,535,43,25,0,1,1,2,1,2,5,1,639,0,2,641,0
90,5,20,388,19,501,1,1,0,1,2,5,5,1,949,0,9,958,0
91,0,7,283,40,806,5,3,1,1,4,4,9,4,1167,0,7,1174,0
92,3,1,249,46,696,6,1,2,1,5,1,7,2,1020,0,4,1024,0
93,3,0,177,12,358,6,1,1,0,5,3,4,2,572,0,10,582,0
94,2,13,508,20,200,1,0,1,0,4,1,0,0,750,0,3,753,0
95,2,31,342,26,211,2,2,0,0,8,5,8,0,637,0,2,639,0
96,4,7,323,8,284,3,1,2,1,4,2,2,4,645,0,2,647,0
97,2,29,629,65,136,1,1,1,1,3,3,6,3,880,0,4,884,0
98,1,34,566,17,15,0,2,1,0,1,0,4,0,641,0,3,644,0
                    gg,0,1,168,9,540,4,0,1,0,6,2,4,0,735,0,7,742,0
100,1,2,290,8,433,0,0,1,1,11,1,14,5,767,0,4,771,0
101,6,48,859,75,24,3,0,3,0,3,1,3,1,1026,0,3,1029,0
102,0,23,509,16,6,0,1,0,0,0,3,6,1,565,0,2,567,0
103,3,22,1101,36,17,0,2,1,1,3,5,13,3,1207,0,13,1220,0
104,1,23,585,17,12,1,0,0,1,1,1,7,1,650,0,5,655,0
105,1,16,589,58,129,1,2,1,2,2,2,5,4,812,0,6,818,0
106,6,3,238,33,292,6,2,1,2,4,7,9,11,614,0,18,632,0
107,2,3,255,13,307,5,2,1,3,6,9,1,5,612,0,16,628,0
108,5,6,401,16,536,13,2,0,2,4,2,7,2,996,0,5,1001,0
109,3,6,315,14,396,8,2,0,3,3,4,9,3,766,0,3,769,0
110,4,4,248,8,251,1,0,0,0,3,1,5,3,528,0,7,535,0
111,11,7,375,22,424,7,4,4,5,4,2,6,4,875,0,9,384,0
112,7,7,153,31,293,4,1,1,4,7,7,8,5,528,0,10,538,0
113,11,24,276,26,369,5,1,2,0,1,4,4,7,730,0,8,738,0
114,5,17,801,47,261,0,1,1,0,3,5,24,3,1168,0,8,1176,0
115,1,10,778,72,42,1,0,0,0,1,2,11,5,923,0,15,938,0
116,0,36,568,37,8,0,2,0,0,1,2,7,5,666,0,6,672,0
117,1,20,548,14,6,1,0,2,0,0,1,1,3,597,0,4,601,0
118,1,2,251,13,372,1,0,1,0,2,1,8,4,656,0,4,660,0
119,2,3,245,13,342,1,0,1,0,3,4,9,2,625,0,12,637,0
120,0,4,251,27,437,2,1,0,1,3,1,6,0,733,0,2,735,0
121,5,4,327,41,586,1,4,2,0,4,0,13,6,993,0,4,997,0
122,2,4,262,17,402,4,2,1,1,2,3,6,3,709,0,4,713,0
123,2,5,272,9,332,0,1,0,0,1,2,9,3,636,0,9,645,0
124,2,2,340,14,483,4,0,0,1,3,5,8,7,869,0,6,875,0
125,2,3,393,18,424,4,1,0,4,9,2,9,6,875,0,7,882,0
126,6,5,334,25,367,3,4,2,0,4,4,8,4,766,0,38,804,0
127,0,3,315,12,372,2,1,1,1,3,0,4,1,715,0,5,720,0
128,0,4,354,16,312,4,4,2,5,7,4,12,3,727,0,8,735,0
129,5,9,180,4,252,1,0,0,0,1,2,1,3,458,0,7,465,0
130,11,8,432,14,576,7,1,4,2,14,16,15,3,1103,0,22,1125,0
131,0,3,370,8,340,5,1,0,0,4,0,11,3,745,0,8,753,0
132,4,5,311,14,663,6,4,1,1,16,4,11,4,1044,0,10,1054,0
133,2,3,284,11,291,2,1,0,1,7,4,5,1,612,0,3,615,0
134,1,3,297,15,558,8,1,1,0,3,4,6,2,899,0,2,901,0
135,0,5,385,13,602,6,1,0,0,6,1,5,4,1028,0,5,1033,0
136,                     s,4,309,14,602,0,0,1,2,2,1,3,1,944,0,1,945,0
137,1,2,307,27,642,5,1,2,0,3,1,6,2,999,0,4,1003,0
138,5,5,474,34,630,9,0,0,3,7,3,5,5,1180,0,17,1197,0
139,5,8,399,23,627,6,0,4,3,6,1,9,3,1094,0,1,1095,0
140,18,38,500,27,340,6,7,8,6,13,5,8,6,982,0,16,998,0
141,5,137,724,24,40,1,3,6,1,1,2,10,2,956,0,2,958,0
142,0,62,674,13,17,0,1,3,0,1,0,7,1,779,0,4,783,0
143,6,34,549,19,189,2,2,1,1,5,3,10,4,825,0,7,832,0
144,2,10,139,20,551,7,0,0,2,9,2,8,5,755,0,7,762,0
145,2,42,555,141,68,1,1,1,2,2,4,6,2,827,0,4,831,0
146,1,6,146,15,458,1,1,4,1,9,1,3,3,649,0,11,660,0
147,5,3,206,22,386,4,4,0,3,3,0,4,4,644,0,6,650,0
148,1,82,588,34,45,3,2,0,1,3,2,8,4,773,0,7,780,0
149,2,56,637,70,45,2,1,2,2,4,2,5,2,830,0,5,835,0
150,5,50,320,20,13,3,1,0,0,1,1,1,2,417,0,2,419,0
151,6,95,682,89,77,2,2,4,6,6,2,10,16,997,0,11,1008,0
152,1,70,390,21,29,0,0,1,3,1,3,12,0,531,0,7,538,0
153,1,42,595,132,20,0,1,0,4,2,1,2,1,801,0,3,804,0
154,2,71,584,103,16,1,1,1,3,2,0,3,1,788,0,4,792,0
155,6,5,175,17,                           4se,3,2,1,1,7,0,5,8,718,0,23,741,0
156,1,3,137,12,385,4,2,2,3,7,1,5,2,564,0,4,568,0
157,4,7,339,13,261,4,1,0,3,13,7,10,2,664,0,10,674,0
158,1,4,210,29,641,2,1,2,1,2,1,1,2,897,0,2,899,0
159,2,7,129,28,565,3,1,0,1,2,2,2,3,745,0,3,748,0
160,1,24,336,33,374,6,1,1,0,3,2,1,3,785,0,5,790,0
161,0,13,415,97,17,1,1,0,0,0,2,4,2,552,0,3,                           65S,0
162,2,9,563,40,114,3,0,0,1,1,2,7,0,742,0,1,743,0
163,0,36,354,87,79,0,1,1,0,1,1,1,0,551,0,4,655,0
164,3,5,261,16,369,3,2,1,0,4,2,5,4,675,0,6,681,0
165,6,2,117,9,641,2,2,1,0,4,4,3,1,792,0,10,802,0
166,4,17,                           42S,25,231,3,2,0,0,0,2,4,1,717,0,                    e,725,0
167,2,59,509,16,235,4,0,0,0,2,1,5,1,834,0,4,838,0
168,3,4,251,9,500,0,1,1,3,4,4,5,2,787,0,3,790,0
169,2,21,615,33,10,0,0,1,0,0,0,7,2,691,0,5,696,0
170,6,33,539,15,51,0,0,1,0,5,1,8,1,660,0,8,668,0
171,5,40,516,12,165,1,0,2,1,4,3,3,0,752,0,4,756,0
172,5,15,311,28,656,3,2,1,0,4,2,5,1,1033,0,2,1035,0
173,1,7,409,12,581,2,0,1,0,1,1,3,0,1018,0,5,1023,0
174,2,4,281,9,647,6,0,0,0,3,4,4,2,962,0,2,964,0
175,5,31,469,61,22,0,1,2,2,0,1,7,2,603,0,3,606,0
176,3,13,401,26,243,3,3,1,1,2,3,8,2,709,0,11,720,0
177,7,5,197,4,225,6,0,2,2,1,2,2,6,459,0,10,469,0
                    17S,1,1,147,4,559,4,2,0,2,7,2,5,0,734,0,4,738,0
179,3,9,317,8,501,2,0,0,1,1,1,1,1,845,0,1,846,0
180,7,3,275,70,464,2,3,1,1,3,5,3,2,839,0,5,844,0
181,0,6,309,17,117,1,1,0,0,0,0,6,0,457,0,2,459,0
182,3,15,668,91,351,2,1,0,4,2,2,6,4,1149,0,11,1160,0
183,1,0,257,4,220,0,0,0,1,0,0,4,0,487,0,3,490,0
184,3,5,132,13,645,2,0,1,3,4,3,2,2,815,0,3,818,0
185,0,8,221,22,566,3,1,1,1,2,4,8,2,839,0,4,843,0
186,0,12,532,155,165,2,2,0,1,4,3,17,0,893,0,2,895,0
187,4,10,320,17,381,1,3,2,0,1,1,4,3,747,0,3,750,0
188,5,6,422,18,143,0,0,0,0,0,0,0,0,594,0,0,594,0
189,2,9,368,33,529,5,0,1,2,5,3,10,3,970,0,7,977,0
190,0,18,716,46,103,1,0,0,1,4,3,5,6,903,0,5,908,0
191,1,5,484,14,146,2,1,0,2,1,0,4,3,663,0,4,667,0
192,0,53,602,19,9,0,1,1,1,1,0,6,1,694,0,5,699,0
193,1,35,614,94,131,2,0,1,3,1,2,4,1,889,0,4,893,0
194,3,27,463,107,48,1,2,1,3,4,2,2,2,665,0,4,689,0
195,2,20,526,35,49,0,0,2,1,1,3,5,3,647,0,8,655,0
196,0,30,500,49,221,1,0,1,2,0,1,9,4,818,0,1,819,0
197,1,23,799,26,10,1,0,0,1,0,0,1,3,865,0,2,867,0
198,0,7,435,10,23,0,0,0,1,0,0,5,0,481,0,0,481,0
199,1,21,976,57,42,0,0,0,1,2,0,7,1,1108,0,3,1111,0
200,0,10,934,30,5,1,0,0,1,0,1,13,2,997,0,2,999,0
201,1,24,1027,24,37,2,0,0,0,1,1,15,2,1134,0,6,1140,0
202,2,6,222,12,527,3,2,0,0,2,1,2,2,781,0,1,782,0
203,0,9,443,11,390,2,2,3,1,4,0,7,2,874,0,9,883,0
204,5,9,621,20,168,2,0,0,0,5,1,19,4,854,0,8,862,0
205,5,20,921,22,23,2,3,0,1,2,3,16,1,1019,0,8,1027,0
206,3,5,428,41,705,2,1,0,1,7,2,6,3,1204,0,7,1211,0
207,3,35,739,40,22,1,0,1,0,0,2,1,2,846,0,5,851,0
208,0,20,586,4,6,0,0,0,0,0,0,5,0,621,0,1,622,0
209,1,10,790,4,11,0,0,0,0,0,1,3,0,820,0,3,823,0
210,1,11,789,14,7,0,0,0,0,0,0,2,0,824,0,0,824,0
211,2,121,731,31,17,0,1,2,6,3,7,7,7,935,0,11,946,0
212,5,24,590,41,14,1,1,1,2,0,1,10,3,693,0,0,693,0
213,2,21,687,31,7,1,0,2,3,0,1,21,4,780,0,4,784,0
214,7,111,750,87,141,1,1,1,2,2,1,4,5,1113,0,5,1118,0
215,2,54,811,23,12,1,1,1,1,0,0,6,1,913,0,12,925,0
216,5,33,949,26,15,1,1,1,1,0,3,12,2,1049,0,                    7  ?,1056,0
217,2,26,800,35,203,3,0,3,1,7,5,17,10,1112,0,17,1129,0
218,0,30,826,30,25,3,0,1,1,0,1,5,3,925,0,7,932,0
219,4,85,621,26,11,1,1,1,0,1,1,0,0,752,0,1,753,0
220,3,27,1051,25,70,0,1,0,0,0,2,8,2,1189,0,0,1189,0
221,1,30,570,62,17,0,0,2,2,1,0,3,0,688,0,4,692,0
222,1,80,538,33,30,1,0,2,0,2,3,13,1,704,0,5,709,0
223,7,45,553,62,361,10,2,6,1,2,6,9,9,1073,0,5,1078,0
224,8,17,887,51,77,5,3,5,1,4,8,19,4,1089,0,9,1098,0
225,4,11,633,60,29,0,0,0,1,0,3,8,0,749,0,3,752,0
226,7,31,449,40,236,1,1,2,0,4,0,12,1,784,0,5,789,0
227,7,44,421,111,350,10,2,3,4,4,4,16,5,981,0,15,996,0
228,9,97,691,14,26,2,3,2,1,0,0,8,1,854,0,5,859,0
229,4,30,734,25,27,0,1,1,2,2,1,3,2,832,0,2,834,0
230,3,41,475,61,94,0,3,1,0,1,1,3,1,684,0,2,686,0
231,1,21,667,50,9,0,0,2,1,0,0,4,1,756,0,4,760,0
232,7,38,623,46,48,3,0,1,3,0,1,12,2,784,0,2,786,0
233,11,19,459,47,190,0,0,4,2,4,2,9,3,750,0,7,757,0
234,1,48,404,47,19,2,0,2,0,1,3,5,4,536,0,3,539,0
235,1,19,909,19,3,2,0,0,0,0,1,2,0,956,0,3,959,0
236,0,46,411,6,4,2,0,0,0,0,1,3,0,473,0,5,478,0
237,3,48,884,60,33,0,2,2,0,0,0,1,3,1036,0,2,1038,0
238,3,23,565,89,11,0,2,0,3,0,0,6,5,707,0,2,709,0
239,3,100,621,38,15,0,0,2,0,2,1,3,1,786,0,5,791,0
240,7,16,517,6,68,1,1,2,3,3,1,11,3,639,0,8,647,0
241,3,107,525,17,14,0,1,1,2,0,1,10,0,681,0,4,685,0
242,3,10,995,10,9,1,0,0,0,3,3,19,8,1061,0,19,1080,0
243,4,19,510,14,9,2,1,3,0,2,1,8,2,575,0,4,579,0
1,3,14,1054,15,14,2,0,2,1,2,3,11,2,1123,0,5,1128,0
2,4,14,398,15,280,0,2,1,2,2,3,16,7,744,0,17,761,0
3,4,29,567,17,135,6,1,2,2,2,3,6,3,777,0,8,785,0
4,3,33,834,12,31,1,1,1,1,2,2,4,4,929,0,7,936,0
5,1,1,255,12,415,5,4,2,1,9,6,15,6,732,0,6,738,0
6,1,4,242,13,453,2,1,2,2,1,0,7,10,738,0,14,752,0
7,4,8,161,10,639,13,1,1,2,1,6,9,4,859,0,11,870,0
8,0,0,0,0,0,0,0,0,0,0,0,0,0,0,0,0,0,0
9,7,8,513,22,204,6,1,1,6,3,4,15,9,799,0,21,820,0
10,0,0,0,0,0,0,0,0,0,0,0,0,0,0,0,0,0,0
11,6,16,837,43,125,2,3,1,1,3,2,14,4,1057,0,6,1063,0
12,4,3,505,11,201,5,2,1,2,0,3,7,5,749,0,5,754,0
13,2,68,727,24,9,1,1,2,0,0,3,7,2,846,0,4,850,0
14,1,15,748,13,14,2,1,0,0,1,0,9,2,806,0,9,815,0
15,6,24,453,21,182,4,3,0,1,3,5,8,2,712,0,9,721,0
16,4,28,544,15,184,3,4,2,3,2,6,5,7,807,0,13,820,0
17,9,13,356,40,"          437  ,","           11    ,",2,3,1,6,10,20,6,914,0,11,925,0
18,2,1,243,14,447,3,0,0,2,1,2,2,3,720,0,0,720,0
20,1,8,402,11,357,4,2,1,2,2,4,8,3,805,0,6,811,0
21,0,12,516,24,326,4,0,2,0,3,2,9,1,899,0,12,911,0
22,2,13,844,30,30,2,1,1,2,1,1,15,1,943,0,19,962,0
23,3,17,790,23,14,0,2,1,1,1,3,21,6,882,0,21,903,0
24,1,15,725,20,18,1,1,2,0,1,2,17,8,811,0,11,822,0
25,3,7,360,15,250,0,1,0,1,3,2,9,2,653,0,11,664,0
26,3,19,608,32,92,6,1,2,0,2,1,9,7,782,0,9,791,0
27,4,4,163,3,371,1,0,0,1,4,5,4,2,562,0,1,563,0
28,0,5,220,13,614,4,5,0,0,5,4,10,5,885,0,9,894,0
29,6,49,679,18,13,3,0,1,0,3,2,13,4,791,0,8,799,0
30,0,23,405,36,7,1,0,0,0,1,3,13,2,491,0,8,499,0
31,4,25,657,8,14,2,2,0,1,0,1,1,3,718,0,3,721,0
32,2,10,464,19,21,0,0,0,3,2,2,7,3,533,0,9,542,0
33,8,8,214,22,643,6,4,0,2,7,2,18,7,941,0,9,950,0
34,1,4,209,19,428,6,0,1,0,4,2,4,6,684,0,8,692,0
35,1,8,288,14,350,3,2,0,2,5,4,12,4,693,0,11,704,0
36,2,5,533,5,97,1,1,0,0,0,1,6,1,652,0,2,654,0
37,0,6,393,11,389,2,0,0,0,5,1,7,2,816,0,12,828,0
38,0,5,151,9,298,3,0,1,0,3,1,11,9,491,0,17,508,0
39,13,29,997,27,56,4,4,3,3,4,4,9,6,1159,0,14,1173,0
40,4,8,625,13,127,1,0,2,1,3,1,7,2,794,0,12,806,0
41,2,12,804,9,27,0,0,1,1,2,1,15,3,877,0,5,882,0
42,2,4,268,9,312,6,0,0,0,7,1,3,3,615,0,0,619,0
43,3,4,491,17,257,0,0,4,0,1,4,13,9,803,0,10,813,0
44,4,18,487,8,132,2,2,0,0,0,3,14,2,672,0,6,678,0
45,8,14,1008,25,40,9,1,1,1,10,9,40,6,1172,0,4,1176,0
46,0,18,880,8,34,2,0,0,2,2,3,18,3,970,0,6,976,0
47,3,8,804,5,10,1,0,0,0,0,1,24,2,858,0,24,882,0
48,1,15,601,6,38,1,0,0,2,0,4,45,8,721,0,6,727,0
49,8,5,860,13,139,4,1,0,2,1,6,18,9,1066,0,16,1082,0
50,11,12,392,25,692,4,5,6,5,4,5,17,9,1187,0,13,1200,0
51,3,2,282,5,259,1,0,0,0,1,1,8,1,563,0,3,566,0
52,7,9,278,24,778,6,2,0,2,8,0,10,3,1127,0,5,1132,0
53,1,3,473,10,205,3,1,0,0,1,0,7,3,707,0,2,709,0
54,3,6,397,21,331,3,2,0,1,4,4,14,4,790,0,8,798,0
55,3,14,541,13,261,2,1,1,1,4,1,14,1,857,0,5,862,0
56,1,5,453,11,553,6,1,1,2,8,5,8,11,1065,0,13,1078,0
57,5,7,332,28,627,4,1,0,1,9,5,9,1,1029,0,5,1034,0
58,5,6,540,8,375,2,2,1,1,7,2,20,9,978,0,18,996,0
59,5,6,211,20,342,6,0,1,0,2,2,4,2,601,0,3,604,0
60,2,7,236,38,339,1,3,1,1,3,3,10,4,648,0,11,659,0
61,1,30,970,9,118,1,1,0,1,3,4,13,3,1154,0,16,1170,0
62,1,17,1073,17,16,1,0,3,0,0,0,10,1,1139,0,17,1156,0
63,2,8,637,11,24,3,2,0,2,0,3,7,4,703,0,3,706,0
64,2,8,617,17,77,4,0,1,0,2,1,14,1,744,0,1,745,0
65,3,17,372,27,400,5,3,1,4,1,2,8,7,850,0,2,852,0
66,3,4,228,4,399,2,1,3,0,12,5,8,1,670,0,0,670,0
67,2,6,429,23,538,5,0,1,2,1,1,8,7,1023,0,12,1035,0
68,2,49,439,17,54,2,0,2,0,2,3,9,2,581,0,8,589,0
69,2,51,483,19,32,1,0,1,1,0,2,12,1,605,0,6,611,0
70,3,2,244,12,313,4,1,0,0,0,1,8,3,591,0,5,596,0
71,12,47,503,22,390,5,1,1,1,6,1,10,0,999,0,6,1005,0
72,1,74,646,50,40,0,1,1,0,1,1,3,4,822,0,7,829,0
73,2,31,240,6,181,4,0,0,2,1,0,2,2,471,0,6,477,0
74,6,4,278,24,602,10,4,1,3,8,9,5,11,965,0,24,989,0
75,0,41,436,21,          155   .,1,0,0,1,4,7,13,1,680,0,2,682,0
76,6,18,192,49,732,8,2,2,1,2,6,2,9,1029,0,6,1035,0
77,5,2,423,24,497,7,4,2,2,5,3,22,9,1005,0,10,1015,0
78,4,1,344,31,339,6,1,1,0,4,1,5,3,740,0,9,749,0
79,4,8,465,19,216,1,1,2,1,4,3,13,6,743,0,5,748,0
80,10,13,321,25,559,6,2,5,8,11,12,12,22,1006,0,23,1029,0
81,1,1,161,10,293,8,2,0,1,1,1,3,2,484,0,2,486,0
82,5,3,154,33,631,5,1,6,5,10,3,12,4,872,0,10,882,0
83,0,2,151,1,397,3,0,0,0,3,0,1,2,560,0,2,562,0
84,2,4,311,22,433,6,5,1,2,3,3,3,2,797,0,12,809,
85,2,10,347,22,455,0,2,3,2,4,4,12,8,871,0,21,892,0
86,1,3,217,23,214,2,2,0,2,1,5,9,2,481,0,4,485,0
87,2,15,197,21,478,3,2,2,0,2,4,3,3,732,0,4,736,0
88,1,7,246,9,232,4,0,2,0,2,2,7,2,514,0,6,520,0
89,0,6,278,20,385,3,0,0,2,4,4,3,2,707,0,1,708,0
90,4,3,172,28,486,5,1,2,3,11,5,17,3,740,0,11,751,0
91,3,1,100,11,314,1,1,0,2,3,3,3,6,448,0,9,457,0
92,1,15,209,8,594,5,0,2,1,6,3,6,2,852,0,10,862,0
93,2,11,158,27,443,7,2,5,3,8,4,12,8,690,0,20,710,0
94,4,12,235,20,431,6,3,2,7,3,5,10,12,750,0,22,772,0
95,1,2,71,4,486,2,0,2,0,0,3,6,1,578,0,5,583,0
96,2,3,137,10,478,2,1,2,1,3,4,6,2,651,0,6,657,0
97,4,23,426,16,404,11,1,1,5,8,7,17,5,928,0,8,936,0
98,0,15,136,14,424,6,2,0,3,1,0,3,8,612,0,9,621,0
99,1,3,42,9,365,0,0,1,0,2,2,2,0,427,0,2,429,0
100,2,18,190,25,504,7,1,3,1,7,2,3,5,768,0,10,778,0
101,2,5,415,25,594,0,2,0,1,2,3,8,6,1063,0,15,1078,0
102,1,3,254,17,741,5,4,0,1,2,5,8,10,1051,0,9,1060,0
103,4,10,256,15,383,7,0,1,1,2,2,2,3,686,0,5,691,0
104,2,6,270,20,332,6,1,0,1,5,7,6,11,667,0,10,677,0
105,6,12,301,14,300,4,0,0,2,1,0,1,2,643,0,2,645,0
106,7,2,229,13,549,6,1,2,1,0,3,4,5,822,0,6,828,0
107,12,4,237,21,564,5,2,0,1,0,3,3,1,853,0,4,857,0
108,4,10,400,24,580,2,0,0,1,0,1,8,3,1033,0,7,1040,0
109,1,2,175,10,449,5,0,0,2,6,0,4,6,660,0,2,662,0
110,5,5,266,14,453,2,2,3,1,0,2,4,7,764,0,4,768,0
111,0,3,193,12,359,1,1,0,0,1,0,2,0,572,0,3,575,0
112,3,10,218,38,418,1,3,1,1,5,5,5,1,709,0,9,718,0
113,2,6,104,35,320,2,0,1,0,3,6,3,5,487,0,2,489,0
114,4,36,331,32,350,6,1,0,1,2,3,10,3,779,0,5,784,0
115,3,6,277,23,314,7,1,0,1,0,1,7,7,647,0,5,652,0
116,3,19,222,115,384,2,1,0,2,3,3,5,3,762,0,3,765,0
117,1,10,176,69,66,1,0,0,1,0,1,4,1,330,0,0,330,0
118,1,29,521,33,489,10,4,0,5,7,4,9,5,1117,0,5,1122,0
119,3,7,299,50,556,10,3,1,0,6,6,6,5,952,0,3,955,0
120,2,3,323,18,457,4,1,0,0,6,5,15,5,839,0,5,844,0
121,5,7,288,11,420,3,3,2,1,2,2,8,9,761,0,8,769,0
122,5,10,473,48,446,3,1,2,1,1,2,8,2,1002,0,6,1008,0
123,3,33,625,36,141,2,1,3,1,1,4,15,2,867,0,5,872,0
124,2,19,602,32,162,1,0,1,3,1,1,5,2,831,0,5,836,0
125,2,0,413,8,165,5,2,0,0,2,1,6,2,606,0,2,608,0
126,2,8,243,27,409,11,0,2,1,7,6,4,4,724,0,7,731,0
127,7,6,262,21,383,3,0,1,2,3,3,7,1,699,0,5,704,0
128,3,4,257,46,632,7,2,1,2,2,0,0,3,959,0,4,963,0
129,2,8,185,26,485,0,2,2,1,1,3,7,1,723,0,5,728,0
130,1,1,70,44,502,1,0,1,1,0,2,2,4,629,0,2,631,0
131,1,12,399,69,413,6,5,0,1,3,2,19,4,934,0,8,942,0
132,0,6,193,32,233,1,0,0,1,3,1,4,2,476,0,5,481,0
133,4,5,349,15,383,1,1,0,1,3,3,7,7,779,0,4,783,0
134,4,2,244,43,185,1,1,0,0,1,2,2,2,487,0,3,490,0
135,1,2,496,101,289,1,1,3,1,1,3,6,4,909,0,3,912,0
136,1,6,231,92,217,1,0,0,0,6,2,3,3,562,0,4,566,0
137,3,13,392,14,222,3,5,1,1,3,7,6,2,672,0,10,682,0
138,3,8,300,21,386,8,0,1,2,3,5,8,5,750,0,15,765,0
139,1,17,909,27,7,0,0,0,1,0,0,1,0,963,0,2,965,0
140,0,21,945,6,8,0,0,1,1,0,0,5,1,988,0,0,988,0
155,1,3,778,1,18,0,0,0,0,1,1,13,0,816,0,6,822,0
156,3,24,575,11,150,4,3,0,1,1,1,7,1,781,0,6,787,0
157,1,46,767,15,8,1,0,0,0,0,0,3,2,843,0,4,847,0
158,5,0,382,8,176,2,2,2,0,3,3,6,5,594,0,11,605,0
159,3,16,569,11,197,3,0,2,0,3,5,9,             i,819,0,9,828,0
160,4,32,865,20,73,2,1,0,1,0,2,16,1,1017,0,8,1025,0
161,7,48,571,26,,0,1,2,0,0,2,11,3,719,0,9,728,0
162,6,2,381,16,"            203   ,",2,0,2,0,2,9,10,3,836,0,5,641,0
163,0,10,442,23,445,6,0,0,1,3,4,10,9,953,0,11,964,0
164,8,3,354,8,            332    .,7,3,2,0,3,3,11,1,735,0,7,742,0
165,0,5,245,5,228,3,1,0,0,0,1,1,0,489,0,1,490,0
166,4,1,278,15,397,6,2,1,0,5,3,4,4,720,0,7,727,0
167,2,13,355,23,471,4,0,1,2,1,0,10,3,885,0,4,889,0
168,3,5,211,60,225,4,1,4,3,5,3,17,2,543,0,4,547,0
169,3,5,314,38,489,4,0,1,1,2,5,4,5,871,0,5,876,0
170,0,6,357,29,448,3,1,0,0,1,1,6,0,852,0,2,854,0
171,6,4,585,24,299,4,5,2,2,6,8,12,3,960,0,4,964,0
172,9,4,595,10,248,3,2,0,1,3,4,6,2,887,0,6,893,0
173,11,11,483,30,490,15,2,1,0,0,1,0,0,1044,0,1,1045,0
174,5,4,393,27,457,1,1,2,1,1,4,1,11,908,0,3,911,0
175,6,7,511,20,312,2,2,3,1,6,3,4,6,883,0,10,893,0
176,0,0,0,0,0,0,0,0,0,0,0,0,0,0,0,0,0,0
177,2,24,268,13,389,8,1,0,1,3,2,11,7,729,0,10,739,0
178,8,5,219,13,525,4,5,0,2,3,0,1,1,786,0,0,786,0
179,3,5,250,27,719,6,1,1,3,6,2,5,6,1034,0,7,1041,0
180,2,36,392,13,227,3,1,0,0,5,0,2,1,682,0,2,684,0
181,2,9,618,17,77,0,0,1,1,0,2,8,1,736,0,3,739,0
182,1,25,606,72,21,0,0,3,0,1,0,8,5,742,0,3,745,0
183,1,22,628,10,84,2,0,0,0,0,1,4,4,756,0,6,762,0
184,2,38,696,48,43,1,0,1,3,0,0,6,3,841,0,1,842,0
185,5,15,490,45,235,1,0,0,2,0,1,8,2,804,0,3,807,0
186,7,6,479,9,164,3,1,0,2,0,0,1,0,672,0,0,672,0
187,8,23,822,37,78,10,1,1,0,1,1,9,3,994,0,7,1001,0
188,4,8,275,10,315,3,1,0,4,3,2,8,4,637,0,6,643,0
189,4,22,346,14,130,0,2,0,2,1,3,6,0,530,0,11,541,0
190,4,7,442,17,198,2,0,1,1,3,3,11,4,693,0,6,699,0
191,10,26,527,12,490,5,0,0,0,1,5,11,5,1092,0,5,1097,0
192,4,8,433,14,404,4,4,3,5,2,3,8,4,896,0,10,906,0
193,0,28,513,12,176,0,2,3,1,3,2,3,2,745,0,8,753,0
194,3,13,222,28,147,1,1,0,0,1,2,2,3,423,0,9,432,0
195,3,9,335,32,693,3,2,1,2,4,5,13,11,1113,0,21,1134,0
196,3,10,         3S9,28,327,7,4,1,1,3,4,9,3,789,0,15,804,0
197,2,6,200,10,225,1,0,0,0,0,2,6,4,456,0,7,463,0
198,9,10,757,33,340,5,0,1,1,2,2,15,5,1180,0,10,1190,0
199,2,3,423,17,380,2,2,0,6,3,6,6,1,851,0,5,856,0
200,2,2,429,14,433,8,4,2,0,7,2,16,11,930,0,25,955,0
201,2,5,316,23,440,5,1,1,2,5,4,2,2,808,0,5,813,0
202,3,4,234,12,347,3,0,1,0,1,2,0,1,608,0,6,614,0
203,2,7,284,11,188,2,1,0,0,2,1,5,1,504,0,0,504,0
204,3,3,318,25,425,9,1,1,3,0,2,8,2,800,0,6,806,0
205,5,4,351,21,531,8,0,3,2,5,2,13,8,953,0,7,960,0
206,3,1,342,11,244,6,4,0,0,2,2,6,1,622,0,0,622,0
207,1,6,241,9,316,1,0,0,0,0,0,2,0,576,0,2,578,0
208,2,2,250,28,440,7,4,3,1,4,4,3,0,748,0,9,757,0
209,3,4,233,28,405,5,0,0,1,2,1,2,5,689,0,5,694,0
210,1,3,327,26,412,7,2,2,3,2,3,5,4,797,0,9,806,0
211,3,18,649,162,186,4,4,1,3,1,2,3,3,1039,0,11,1050,0
212,3,6,461,24,174,3,1,1,1,2,0,9,2,687,0,3,690,0
213,2,33,499,30,"            264   ,",6,0,2,1,2,1,6,3,849,0,2,851,0
214,2,5,362,45,            181   ?,3,1,0,0,1,1,1,0,602,0,5,607,0
215,4,17,435,45,            281    -,5,0,0,3,2,4,10,6,812,0,9,821,0
216,1,8,562,40,            160   ',1,0,2,4,0,2,7,5,792,0,6,798,0
217,3,6,211,13,            138   ?,1,1,1,0,1,0,4,,379,0,4,383,0
218,4,17,461,49,            74   ?,6,0,1,0,1,1,8,5,627,0,6,633,0
219,8,5,225,24,"            300   ,",8,4,5,5,6,2,10,6,608,0,14,622,0
220,2,2,409,30,"           493  ,",4,2,0,0,1,0,5,5,953,0,21,974,0
221,3,9,379,43,            541  -,4,1,0,1,3,6,12,5,1007,0,13,1020,0
222,2,3,223,15,313,4,1,0,2,1,1,6,2,573,0,2,575,0
223,5,7,276,39,501,3,2,2,0,0,0,4,6,845,0,11,856,0
224,7,20,629,70,           341  ',9,2,0,1,6,7,10,6,1108,0,15,1123,0
225,6,12,386,38,489,5,8,3,3,13,7,17,6,993,0,8,1001,0
226,2,2,500,11,259,3,2,1,0,0,1,10,5,796,0,7,803,0
227,1,5,398,14,276,6,0,2,1,3,2,11,2,721,0,3,724,0
228,2,5,347,7,236,1,1,1,0,3,1,6,3,613,0,2,615,0
229,2,2,535,12,127,2,0,1,0,3,1,8,0,693,0,3,696,0
230,2,3,414,23,          379   -,2,0,0,0,2,5,13,0,843,0,13,856,0
231,4,5,501,4,          8A-,1,0,0,0,1,0,1,0,602,0,0,602,0
232,2,6,282,31,          428  ',2,0,0,1,1,4,7,3,767,0,3,770,0
233,6,4,269,39,441,19,2,0,0,0,1,3,2,786,0,0,786,0
234,4,7,399,17,          419  ',5,0,1,0,4,4,4,3,867,0,5,872,0
235,4,7,235,11,428,5,2,0,0,3,1,8,3,707,0,5,712,0
236,2,7,499,16,          204 ',3,1,0,1,3,1,9,5,751,0,7,758,0
237,0,4,516,23,          260  ?,0,2,0,0,2,2,8,1,818,0,4,822,0
238,5,4,605,20,503,6,2,2,0,1,2,6,4,1160,0,5,1165,0
239,3,5,435,20,576,13,6,3,1,2,5,7,6,1082,0,16,1098,0
240,2,1,450,12,203,1,1,0,0,1,0,5,2,678,0,3,681,0
241,2,3,202,7,357,3,2,0,2,4,3,4,2,591,0,5,596,0
242,5,7,497,32,496,3,6,3,1,2,3,3,5,1063,0,7,1070,0
243,0,5,425,27,515,9,4,3,1,3,8,16,10,1026,0,8,1034,0
244,1,6,346,18,383,2,1,0,1,1,1,5,2,772,0,7,779,0
245,3,3,166,6,312,4,0,2,1,1,2,7,1,508,0,1,509,0
246,0,2,182,6,277,3,1,0,1,4,1,1,1,479,0,2,481,0
247,2,2,242,11,445,4,0,0,0,4,4,4,6,724,0,6,730,0
248,10,3,412,33,487,11,1,3,1,4,6,9,8,988,0,11,999,0
249,4,5,311,4,278,1,1,1,4,0,1,3,1,614,0,6,620,0
8,5,16,493,32,448,3,2,3,2,7,14,20,9,1054,0,16,1070,0
10,4,19,615,22,326,3,1,5,2,5,6,18,4,1030,0,13,1043,0
176,6,               S,298,20,405,0,0,0,0,6,2,8,2,755,0,2,757,0
1,1,38,884,24,88,1,0,2,3,1,0,7,3,1052,0,7,1059,0
2,1,67,525,17,17,0,0,3,1,1,1,8,1,642,0,7,649,0
3,2,75,600,44,9,0,0,1,5,1,1,5,0,743,0,2,745,0
4,4,175,550,45,26,0,0,4,2,1,0,8,2,817,0,4,821,0
5,4,12,175,36,569,1,1,0,0,1,0,3,2,804,0,5,809,0
6,5,7,364,19,414,2,1,0,0,4,3,3,5,827,0,4,831,0
7,1,3,196,28,405,1,0,0,0,0,0,2,0,636,0,4,640,0
8,1,8,314,20,432,0,0,0,0,7,0,9,1,792,0,4,796,0
9,2,71,403,25,240,5,2,1,0,1,3,5,0,758,0,7,765,0
10,5,289,502,36,6,0,1,7,0,1,2,5,5,859,0,3,862,0
11,1,21,381,23,564,1,0,1,0,2,0,8,3,1005,0,4,1009,0
12,1,3,142,35,490,5,2,1,0,0,0,4,1,684,0,0,684,0
13,0,33,525,22,450,2,0,1,5,3,0,8,1,1050,0,2,1052,0
14,4,48,858,52,58,0,1,0,3,0,1,8,2,1035,0,8,1043,0
15,2,33,268,51,530,5,2,3,1,6,3,2,1,907,0,1,908,0
16,1,17,249,87,644,6,1,0,0,0,4,1,2,1012,0,2,1014,0
17,2,53,197,26,811,2,1,4,1,1,2,2,3,1105,0,4,1109,0
18,3,117,362,30,424,1,0,2,1,2,2,4,2,950,0,4,954,0
19,2,20,518,8,118,2,0,2,0,0,0,17,0,687,0,10,697,0
20,3,165,699,38,17,1,0,5,1,0,1,12,2,944,0,1,945,0
21,1,54,536,5,85,1,1,0,0,1,5,18,1,708,0,3,711,0
22,4,19,193,10,207,2,0,0,0,4,6,8,2,455,0,1,456,0
23,0,382,496,15,57,2,1,5,0,3,4,11,3,979,0,8,987,0
24,0,18,174,7,378,1,0,0,1,4,2,0,0,585,0,5,590,0
25,2,240,707,38,58,2,0,2,4,1,2,13,3,1072,0,3,1075,0
26,0,2,132,5,558,0,0,0,0,7,0,1,0,705,0,3,708,0
27,6,145,771,43,19,4,2,3,3,0,1,9,3,1009,0,7,1016,0
28,2,120,415,17,99,2,0,1,1,0,2,11,2,672,0,5,677,0
29,3,212,671,30,8,0,1,2,0,1,1,3,3,935,0,5,940,0
30,0,155,431,36,62,0,1,2,0,3,3,9,2,704,0,4,708,0
31,3,51,228,8,117,2,0,1,0,0,0,8,0,418,0,1,419,0
32,3,152,560,23,211,0,1,2,2,2,3,6,0,965,0,14,979,0
33,4,224,562,19,89,2,0,1,0,2,3,10,6,922,0,5,927,0
34,2,193,494,8,76,1,0,4,0,1,3,14,1,797,0,9,806,0
35,2,128,734,33,214,3,0,4,2,2,0,3,2,1127,0,6,1133,0
36,5,189,486,36,220,4,1,5,3,3,3,6,2,963,0,5,968,0
37,7,179,662,35,15,0,1,3,0,1,1,13,1,918,0,5,923,0
38,1,44,378,14,209,0,1,2,2,3,2,16,0,672,0,7,679,0
39,2,79,757,57,80,0,0,3,0,2,3,10,7,1000,0,7,1007,0
40,1,125,783,13,72,1,0,2,0,1,1,10,0,1009,0,2,1011,0
41,4,30,692,11,392,4,2,2,0,1,3,9,6,1156,0,11,1167,0
42,2,21,117,11,199,2,0,0,0,2,2,5,0,361,0,0,362,0
43,3,9,217,18,776,10,1,0,1,3,5,12,4,1059,0,3,1062,0
44,1,12,157,9,473,0,0,1,1,2,0,12,0,668,0,2,670,0
45,0,38,381,9,445,9,1,0,1,3,3,7,4,901,0,4,905,0
46,1,52,287,8,330,3,2,2,3,5,4,19,4,720,0,6,726,0
47,1,3,130,13,492,5,1,0,0,8,2,7,3,665,0,1,666,0
48,2,11,245,11,513,2,0,0,2,8,3,16,3,816,0,8,824,0
49,0,26,1147,14,5,0,0,0,1,1,0,9,3,1206,0,17,1223,0
50,1,32,425,8,159,0,1,0,1,0,2,10,7,646,0,11,657,0
51,1,45,507,15,145,4,0,2,1,1,1,5,1,728,0,3,731,0
52,1,2,240,4,504,10,3,0,1,7,4,17,1,794,0,7,801,0
53,1,98,413,10,19,1,0,4,1,1,0,4,3,555,0,2,557,0
54,3,182,538,14,54,2,1,2,1,0,2,7,3,809,0,6,815,0
55,0,16,88,17,962,4,1,3,1,1,1,1,3,1098,0,5,1103,0
56,2,7,298,19,646,2,1,3,0,4,2,6,3,993,0,4,997,0
57,3,49,919,12,6,0,5,0,1,0,0,3,0,998,0,5,1003,0
58,3,      6S,946,13,54,1,1,1,2,1,0,10,0,1100,0,5,1105,0
59,0,42,628,94,59,0,2,1,0,0,2,4,1,833,0,4,837,0
60,2,54,669,121,157,4,0,4,0,2,2,3,1,1019,0,4,1023,0
61,5,18,724,22,170,3,0,2,1,4,2,15,3,969,0,7,976,0
62,2,17,353,3,227,6,1,1,1,4,1,6,3,625,0,5,630,0
63,3,46,525,18,6,1,2,3,0,2,2,6,4,618,0,1,619,0
64,6,66,506,19,47,1,0,2,1,1,3,4,0,656,0,3,659,0
65,2,78,714,50,224,0,5,3,5,4,8,15,4,1112,0,7,1119,0
66,1,92,548,28,94,2,2,3,2,1,1,9,0,783,0,9,792,0
67,1,45,518,5,95,1,0,3,1,2,3,7,0,681,0,4,685,0
68,6,22,564,20,295,3,0,3,0,4,0,1,0,918,0,3,921,0
69,1,35,833,29,6,1,0,0,0,0,1,7,0,913,0,3,916,0
70,1,87,466,35,13,3,2,5,4,2,1,7,1,627,0,8,635,0
71,0,102,600,28,22,0,0,0,0,1,1,2,1,757,0,2,759,0
72,2,29,230,23,212,0,0,2,1,1,1,2,2,505,0,2,507,0
73,2,88,646,22,14,1,0,5,4,0,1,3,0,786,0,0,786,0
74,5,30,335,31,254,4,2,0,0,4,1,1,5,672,0,2,674,0
75,0,76,324,44,170,1,0,2,1,0,2,3,1,624,0,2,626,0
76,0,31,691,19,102,1,0,2,0,1,1,5,0,853,0,1,854,0
77,0,164,604,15,55,3,1,1,0,1,0,3,1,848,0,0,848,0
78,0,38,1084,12,6,0,0,0,0,0,2,6,0,1148,0,6,1154,0
79,0,26,839,5,77,2,1,0,3,5,1,17,0,976,0,5,981,0
80,2,8,268,3,132,0,0,0,0,3,3,5,3,427,0,2,429,0
81,1,28,901,12,2,1,0,1,3,0,1,3,2,955,0,0,955,0
82,1,20,1056,4,2,0,0,0,0,1,0,2,0,1086,0,0,1086,0
83,3,32,890,10,9,0,0,0,1,2,3,3,0,953,0,2,955,0
84,0,39,714,11,43,0,0,0,0,0,0,3,1,811,0,4,815,0
85,2,33,788,19,8,0,0,0,0,0,0,7,1,858,0,0,858,0
86,3,163,559,93,130,0,0,5,0,2,1,5,1,962,0,1,963,0
87,0,77,574,44,151,0,0,2,1,3,1,2,2,857,0,2,859,0
88,1,96,793,6,36,1,0,1,0,3,0,17,1,955,0,6,961,0
89,2,12,178,43,601,2,0,2,0,2,2,2,2,848,0,9,857,0
90,0,2,195,12,507,4,3,4,2,4,2,7,3,745,0,5,750,0
91,4,5,142,14,367,9,1,0,1,2,5,4,4,558,0,3,561,0
92,10,13,344,9,291,0,1,1,0,7,2,10,3,691,0,4,695,0
93,2,20,704,14,30,0,1,0,2,1,3,14,3,794,0,11,805,0
94,4,30,305,26,201,0,0,0,0,2,0,5,1,574,0,1,575,0
95,2,51,377,14,184,5,0,2,1,2,1,4,0,643,0,2,645,0
96,2,69,749,7,12,2,3,3,0,2,1,3,3,856,0,1,857,0
97,1,52,658,21,11,1,3,2,5,1,0,4,1,760,0,4,764,0
98,4,10,280,20,711,2,2,2,3,6,1,3,2,1046,0,2,1048,0
99,0,      IS,303,13,554,3,0,0,0,2,0,7,2,902,0,5,907,0
100,5,146,745,20,70,0,0,0,0,0,0,1,3,990,0,2,992,0
101,0,99,385,27,3,0,0,1,6,3,0,4,5,533,0,4,537,0
102,2,214,549,37,13,0,4,0,1,0,1,2,2,825,0,5,830,0
103,1,45,398,35,5,1,1,1,0,1,0,2,1,491,0,2,493,0
104,2,70,476,50,160,0,0,0,0,4,0,4,1,767,0,4,771,0
105,0,6,215,64,628,12,0,1,0,2,0,3,0,931,0,2,933,0
106,8,90,607,71,14,0,0,1,1,2,2,3,3,802,0,4,806,0
107,3,148,548,122,143,2,0,5,1,3,0,11,4,990,0,4,994,0
108,6,66,735,106,9,0,2,1,8,2,1,13,2,951,0,8,959,0
109,0,0,186,23,530,7,0,2,1,8,2,6,2,767,0,2,769,0
110,1,95,991,65,9,0,0,2,7,0,1,3,5,1179,0,9,1188,0
111,5,123,680,37,11,1,2,5,1,0,1,2,2,870,0,2,872,0
112,5,144,409,41,7,1,0,4,1,1,2,6,3,624,0,2,626,0
113,2,200,490,42,40,0,1,8,0,0,1,3,4,791,0,6,797,0
114,6,82,414,168,238,4,0,3,6,0,5,8,7,941,0,13,954,0
115,2,259,614,83,53,2,0,8,5,0,1,5,1,1033,0,3,1036,0
116,0,108,493,93,7,0,0,1,1,0,1,4,0,708,0,1,709,0
117,5,59,383,78,212,2,2,1,2,0,1,8,2,755,0,3,758,0
118,4,74,280,25,60,0,0,2,1,1,4,7,0,458,0,9,467,0
119,3,158,559,29,7,0,0,4,4,1,3,12,1,781,0,6,787,0
120,5,272,435,10,107,1,0,4,2,0,2,6,5,849,0,4,853,0
121,2,181,416,93,36,1,0,2,8,0,1,4,2,746,0,10,756,0
122,4,127,267,73,207,0,0,0,1,1,1,5,2,688,0,2,690,0
123,4,35,366,112,144,0,1,2,1,2,1,5,2,675,0,1,676,0
124,5,142,652,51,177,6,0,6,0,0,0,2,2,1043,0,2,1045,0
125,3,117,339,45,85,4,0,5,3,1,4,11,3,620,0,4,624,0
126,4,27,125,22,369,1,0,0,0,4,0,3,2,557,0,3,560,0
127,3,183,517,15,109,1,0,8,0,2,2,8,2,850,0,4,854,0
128,0,388,605,63,22,1,0,5,2,0,0,2,2,1090,0,0,1090,0
129,4,221,412,17,8,0,1,2,1,0,1,4,3,674,0,5,679,0
130,3,99,459,36,23,1,0,3,1,1,1,3,1,631,0,1,632,0
131,3,112,407,10,3,0,0,0,0,0,0,1,1,537,0,1,538,0
132,3,110,578,129,35,0,1,4,0,1,3,1,1,866,0,3,869,0
133,0,77,559,94,10,0,1,2,0,0,0,4,0,747,0,0,747,0
134,3,109,516,188,9,2,2,4,1,3,2,7,0,846,0,2,848,0
135,1,76,406,       S,47,1,0,5,0,2,0,4,2,552,0,5,557,0
136,0,35,494,9,9,0,0,0,0,0,0,2,2,551,0,1,552,0
137,1,81,665,83,125,0,1,0,1,1,1,4,4,967,0,6,973,0
138,1,19,348,13,379,1,0,0,0,2,1,4,1,769,0,1,770,0
139,2,12,310,17,418,2,1,0,2,4,0,6,0,774,0,4,778,0
140,0,19,181,23,568,2,0,0,1,0,0,3,2,799,0,3,802,0
141,2,30,235,29,736,1,0,4,1,2,1,3,3,1047,0,5,1052,0
142,1,20,135,10,710,3,0,2,0,3,1,0,0,885,0,6,891,0
143,2,15,126,24,662,3,0,2,1,1,1,0,0,837,0,3,840,0
144,0,7,93,16,569,5,0,0,0,1,1,0,2,694,0,3,697,0
145,1,5,100,14,506,1,0,0,1,1,0,1,2,632,0,2,634,0
146,3,6,142,22,866,4,1,1,1,2,3,3,1,1055,0,8,1063,0
147,0,23,180,35,788,5,0,0,0,1,1,0,3,1036,0,2,     103S,0
148,0,12,77,16,299,0,0,0,0,1,0,0,0,405,0,0,405,0
149,1,4,59,25,341,4,0,0,0,0,0,2,0,436,0,2,438,0
150,1,36,256,9,76,0,0,1,0,2,1,4,0,386,0,1,387,0
151,0,19,252,7,130,1,3,0,0,0,0,9,1,422,0,2,424,0
152,2,17,303,19,684,4,0,0,1,5,1,13,2,1051,0,8,1059,0
153,1,9,144,21,748,0,2,2,2,9,1,8,2,949,0,5,954,0
164,1,4,80,11,336,1,0,0,0,3,2,0,1,439,0,5,444,0
155,2,6,102,12,550,5,0,2,1,2,0,1,2,685,0,4,689,0
156,1,10,262,20,345,0,1,0,2,1,1,4,1,648,0,7,655,0
157,1,11,347,19,358,0,0,0,1,0,0,9,3,749,0,4,753,0
158,2,11,320,41,560,1,0,0,0,0,2,2,0,939,0,4,943,0
159,0,3,336,23,631,2,0,0,1,0,2,4,1,1003,0,1,1004,0
160,0,14,346,18,509,10,1,1,2,1,4,7,2,915,0,2,917,0
161,2,15,249,35,377,2,1,0,1,0,0,0,0,682,0,3,685,0
162,2,2,297,11,767,2,0,0,0,4,1,7,2,1095,0,2,1097,0
163,0,175,587,8,127,1,1,0,1,2,2,13,0,917,0,6,923,0
164,1,24,105,8,267,1,0,0,0,0,0,0,0,406,0,1,407,0
165,0,39,303,19,522,0,1,0,0,1,0,5,1,891,0,1,892,0
166,1,36,359,14,219,3,0,0,3,0,1,2,1,639,0,5,644,0
167,4,119,717,12,60,1,0,2,0,0,1,8,1,925,0,7,932,0
168,2,21,227,31,396,1,0,0,2,2,0,1,1,684,0,5,689,0
169,1,10,135,67,701,3,1,0,0,1,1,1,2,923,0,8,931,0
170,0,37,331,64,407,2,0,2,1,1,1,3,2,851,0,5,856,0
171,2,10,344,38,465,0,0,0,0,0,0,5,1,865,0,3,868,0
172,1,82,332,26,562,4,2,0,2,5,2,14,7,1019,0,5,1024,0
173,3,85,313,22,411,2,0,1,0,2,3,7,3,852,0,8,860,0
174,2,69,211,27,370,2,0,2,1,1,2,8,2,697,0,3,700,0
175,4,17,266,35,534,2,1,2,"      0,",6,1,7,2,877,0,6,883,      0    \
176,1,4,239,28,520,2,1,1,1,7,3,5,2,814,0,4,818,0
177,0,12,411,13,223,0,1,0,1,1,3,4,1,670,0,0,670,0
178,2,31,387,27,114,0,0,0,0,2,0,4,0,567,0,6,573,0
179,1,47,116,6,116,3,0,1,3,2,1,1,2,299,0,2,301,0
180,2,52,819,20,20,0,0,2,0,5,3,14,1,938,0,2,940,0
181,1,47,150,20,382,2,2,3,0,1,1,5,2,616,0,2,618,0
182,9,43,600,66,357,3,1,0,2,10,4,29,3,1127,0,17,1144,0
183,3,26,273,81,629,3,0,2,1,      14    .,5,14,1,1052,0,10,1062,0
184,2,4,237,31,618,2,0,1,2,4,1,2,1,905,0,4,909,0
185,2,9,202,21,443,1,2,1,3,2,1,10,2,699,0,3,702,0
186,1,5,167,15,457,2,2,1,1,3,2,4,1,661,0,3,664,0
187,0,5,150,8,570,4,0,0,0,5,2,0,0,744,0,6,750,0
188,4,14,270,21,739,0,4,1,1,5,2,8,0,1069,0,4,1073,0
      189  1,0,11,166,30,302,0,1,0,0,0,0,3,0,513,0,0,513,0
190,0,24,267,16,212,3,0,1,0,1,1,1,0,526,0,3,529,0
191,3,8,150,19,565,3,4,2,2,2,2,4,2,766,0,6,772,0
192,1,7,139,11,461,6,0,2,2,4,4,4,1,642,0,2,644,0
193,0,8,415,22,155,2,1,2,0,1,3,9,1,619,0,7,626,0
194,2,15,323,27,211,8,0,0,0,2,0,9,0,597,0,2,599,0
195,0,        X,184,77,642,3,0,1,1,10,0,3,1,923,0,4,927,0
196,2,2,102,15,419,1,1,0,0,1,2,2,0,547,0,3,550,0
197,0,3,167,20,443,1,0,0,1,0,0,4,1,640,0,2,642,0
198,2,4,98,55,529,4,1,2,1,5,0,3,0,704,0,0,704,0
199,0,10,246,27,362,2,1,0,0,0,3,1,0,652,0,2,654,0
201,1,5,172,22,256,2,0,0,0,1,0,0,0,459,0,2,461,0
202,0,6,249,30,304,2,0,1,0,0,1,0,0,593,0,1,594,0
204,1,29,242,21,363,0,0,1,0,0,1,0,0,658,0,3,661,0
205,2,23,242,55,728,1,0,2,0,1,0,0,2,1056,0,5,1061,0
206,0,14,169,71,642,5,0,1,3,4,1,3,2,915,0,6,921,0
207,0,6,110,26,366,1,1,2,0,1,0,2,0,515,0,3,518,0
208,1,17,147,10,326,0,0,0,0,0,0,0,1,502,0,3,505,0
209,1,12,147,32,525,3,0,0,2,1,2,2,5,732,0,5,737,0
210,1,18,120,25,360,0,0,0,0,0,1,0,0,525,0,4,529,0
211,2,9,103,34,331,2,0,0,3,1,0,4,1,490,0,2,492,0
212,1,14,74,15,257,3,1,0,0,0,0,2,1,368,0,4,372,0
213,1,28,180,46,470,0,1,1,1,1,0,0,1,730,0,6,736,0
214,0,2,115,15,450,3,0,1,0,2,1,0,1,590,0,5,595,0
215,3,7,150,16,424,4,0,0,1,5,0,2,3,615,0,5,620,0
216,2,12,121,32,636,6,0,1,0,1,0,1,2,814,0,0,814,0
217,1,40,172,66,381,0,0,0,0,1,0,2,0,663,0,2,665,0
218,0,24,129,33,376,6,0,1,0,3,3,1,2,578,0,3,581,0
219,2,37,145,28,460,0,0,2,1,6,2,4,4,691,0,6,697,0
220,1,28,209,19,482,1,0,3,3,6,5,4,2,763,0,7,770,0
221,4,29,196,12,495,2,1,1,1,5,2,3,0,751,0,2,753,0
222,0,10,98,47,275,1,1,0,0,0,0,0,0,432,0,3,435,0
223,1,2,96,45,354,3,1,0,0,0,0,1,0,503,0,3,506,0
224,1,26,146,31,570,1,0,1,0,0,0,2,2,780,0,4,784,0
225,3,2,139,30,549,1,4,0,1,10,2,6,4,751,0,4,755,0
226,1,6,171,23,391,2,0,1,0,0,0,1,1,597,0,4,601,0
227,1,38,701,13,145,1,1,4,7,5,1,12,3,932,0,2,934,0
228,4,35,735,9,82,2,1,1,1,4,1,18,2,895,0,7,902,0
229,6,8,213,50,682,4,1,5,3,6,8,12,9,1007,0,24,1031,0
230,3,9,270,23,507,4,1,1,1,3,2,2,1,827,0,5,832,0
231,1,16,166,20,557,3,0,1,3,4,1,3,1,776,0,6,782,0
232,1,16,141,37,581,4,1,0,1,3,4,5,0,794,0,1,795,0
233,2,8,181,15,301,1,1,0,0,2,0,2,4,517,0,1,518,0
234,4,3,176,16,601,3,1,0,0,4,2,0,2,812,0,3,815,0
235,0,25,394,18,341,2,0,1,2,1,2,14,3,803,0,6,809,0
236,0,12,193,13,380,4,1,1,0,2,1,5,3,615,0,2,617,0
237,3,27,437,14,197,2,1,0,1,1,2,10,4,699,0,8,707,0
238,0,9,300,5,311,5,0,1,0,1,1,5,1,639,0,5,644,0
239,2,14,534,31,417,4,3,0,6,4,2,11,4,1032,0,11,1043,0
240,3,14,321,16,417,1,0,1,0,4,1,7,5,790,0,5,795,0
241,4,9,230,15,428,1,1,0,2,4,3,10,1,708,0,5,713,0
242,0,15,68,21,400,4,0,0,0,0,2,0,0,510,0,3,513,0
243,1,16,258,8,223,5,1,3,2,3,4,5,2,531,0,7,538,0
244,2,8,223,13,316,0,1,4,2,3,5,3,0,580,0,2,582,0
245,0,6,177,3,531,3,0,0,0,0,1,3,1,725,0,1,726,0
246,0,6,39,12,390,1,0,1,0,1,1,0,2,453,0,1,454,0
247,6,34,820,3,11,2,3,0,1,3,2,20,4,909,0,2,911,0
248,1,39,997,11,6,0,3,2,0,2,0,8,0,1069,0,5,1074,0
249,4,9,416,9,404,5,3,3,2,3,9,14,3,884,0,11,895,0
250,1,18,422,10,379,2,2,0,2,4,0,4,0,844,0,3,847,0
251,1,3,77,9,444,4,1,1,0,3,1,1,1,546,0,3,549,0
252,0,9,253,20,541,20,0,0,1,3,1,2,0,850,0,9,859,0
253,0,9,227,22,483,6,0,0,0,2,2,2,1,754,0,7,761,0
254,4,32,571,14,247,2,1,0,2,4,2,6,0,885,0,2,887,0
255,2,10,163,20,135,1,0,2,0,0,0,5,0,338,0,0,338,0
256,6,5,128,147,714,2,1,1,6,8,3,3,3,1027,0,4,1031,0
257,2,24,478,25,510,1,1,0,2,0,2,5,3,1053,0,2,1055,0
258,6,3,102,22,517,4,2,1,1,4,4,1,2,669,0,5,674,0
259,1,4,115,19,386,0,0,0,0,4,0,3,0,532,0,10,542,0
260,1,11,150,53,581,4,0,0,0,2,1,3,1,807,0,2,809,0
261,1,     a,128,22,489,2,0,0,0,4,2,3,2,661,0,8,669,0
262,1,4,127,15,482,2,0,0,0,0,0,1,1,633,0,4,637,0
263,1,6,242,15,696,3,1,1,1,9,2,6,1,984,0,7,991,0
264,2,16,225,9,691,2,0,0,0,5,1,7,3,961,0,7,968,0
265,2,11,313,24,431,4,0,1,1,1,1,3,0,792,0,3,795,0
266,1,2,264,9,281,0,0,0,0,3,2,2,2,566,0,4,570,0
267,2,8,258,26,354,0,0,0,1,2,0,4,1,656,0,9,665,0
268,1,6,87,51,225,1,0,0,0,2,0,0,0,373,0,6,379,0
269,2,12,182,30,643,5,0,0,1,3,2,2,0,882,0,0,882,0
270,3,28,267,22,356,1,1,0,0,1,0,1,1,681,0,1,682,0
271,3,21,241,36,206,1,1,0,0,0,1,5,5,520,0,3,523,0
272,3,24,450,105,437,0,1,1,1,3,3,17,4,1049,0,2,1051,0
273,1,44,342,11,227,1,0,0,2,2,1,1,1,633,0,2,635,0
274,4,14,257,11,424,2,0,0,0,2,1,7,0,722,0,6,728,0
275,5,9,155,32,783,2,3,1,2,2,5,9,1,1009,0,3,1012,0
276,4,2,131,16,603,1,2,0,1,10,4,5,5,784,0,5,789,0
277,0,11,200,9,652,4,0,0,0,5,2,4,4,891,0,4,895,0
278,0,11,380,7,348,1,1,2,0,3,1,11,1,766,0,5,771,0
279,2,18,356,18,426,1,0,0,2,3,1,8,2,837,0,3,840,0
280,0,27,299,5,234,2,0,2,0,2,3,3,2,579,0,1,580,0
281,1,21,279,19,312,2,0,0,0,1,0,4,1,640,0,1,641,0
282,2,4,128,10,499,2,0,2,1,5,0,6,4,663,0,3,666,0
283,1,11,118,12,525,4,0,3,1,0,1,1,2,679,0,2,681,0
284,0,15,127,20,542,1,1,0,0,6,1,1,4,718,0,7,725,0
285,0,4,128,16,482,3,0,0,1,1,1,2,3,641,0,3,644,0
286,0,9,121,7,353,1,0,0,0,5,1,4,1,502,0,2,504,0
287,2,13,266,12,328,1,0,0,1,2,3,9,1,638,0,1,639,0
288,1,4,74,13,321,1,0,0,0,4,2,3,0,423,0,3,426,0
289,1,6,145,12,712,6,1,1,0,4,4,1,7,900,0,4,904,0
1,2,3,4,5,6,7,8,9,10,11,12,13,14,15,16,17,18,19
43,1,23,476,31,283,1,0,0,0,2,0,3,0,820,0,3,823,0
44,0,60,384,106,390,2,2,1,0,6,1,2,2,956,0,3,959,0
45,1,110,811,8,43,1,0,4,3,1,2,5,1,990,0,1,991,0
46,0,142,741,32,12,1,0,2,0,0,2,3,2,937,0,6,943,0
47,0,6,224,7,551,1,0,0,0,3,0,8,1,801,0,1,802,0
48,2,68,268,8,144,0,1,2,0,2,1,3,0,499,0,1,500,0
49,3,128,419,41,440,1,2,1,2,6,1,11,4,1059,0,0,1059,0
50,0,97,580,111,6,1,0,2,2,0,1,3,1,804,0,0,804,0
51,1,44,310,79,1,0,1,0,0,0,2,1,0,439,0,1,440,0
52,4,299,624,83,10,0,0,2,0,0,4,5,0,1031,0,5,1036,0
53,3,155,443,175,4,0,1,4,2,3,3,5,1,799,0,4,803,0
54,0,71,310,149,8,0,0,0,0,0,1,2,1,542,0,1,543,0
55,2,102,505,131,3,0,0,0,1,0,0,1,0,745,0,1,746,0
56,0,113,477,199,4,0,1,1,5,0,2,0,0,802,0,2,804,0
57,4,136,195,27,89,0,1,8,0,1,1,2,2,466,0,3,469,0
58,4,273,600,97,75,0,1,4,1,0,1,8,4,1068,0,6,1074,0
59,1,252,477,105,51,0,0,8,2,0,2,4,5,907,0,10,917,0
60,2,234,286,18,2,1,0,2,2,0,1,0,0,548,0,2,550,0
61,1,175,340,28,109,0,0,2,1,1,2,1,2,662,0,2,664,0
62,4,323,396,69,363,2,1,      S,3,2,3,13,9,1196,0,16,1212,0
63,2,      S3,468,131,205,1,0,2,2,0,2,4,1,901,0,4,905,0
64,0,58,196,23,151,1,1,1,1,1,1,0,2,436,0,2,438,0
65,2,103,557,130,7,0,0,3,2,0,1,2,0,807,0,7,814,0
66,1,16,143,19,213,2,0,0,0,1,0,2,0,397,0,2,399,0
67,1,43,360,265,62,0,0,0,3,2,1,5,3,745,0,4,749,0
68,1,31,288,91,183,2,0,3,2,0,0,5,2,608,0,1,609,0
69,1,69,160,21,548,0,2,1,0,0,0,2,2,806,0,1,807,0
70,2,11,122,5,441,1,0,0,1,0,1,1,0,585,0,1,586,0
71,2,374,563,37,72,1,0,4,1,1,1,4,1,1061,0,4,1065,0
72,2,186,312,13,66,0,0,4,1,2,1,7,3,597,0,2,599,0
73,3,154,647,78,298,2,2,4,1,2,0,4,2,1197,0,1,1198,0
74,0,51,346,35,11,0,0,0,0,0,0,3,1,447,0,2,449,0
75,0,101,444,16,377,2,1,1,0,2,4,11,2,961,0,7,968,0
76,3,193,423,9,4,1,1,4,0,2,1,11,2,654,0,3,657,0
77,4,29,473,23,20,1,0,1,0,0,3,0,4,558,0,5,563,0
78,3,243,425,15,272,2,2,8,4,3,3,6,1,987,0,8,995,0
79,0,48,154,36,234,3,1,0,5,1,1,0,2,485,0,2,487,0
80,1,4,382,14,476,3,1,1,1,8,3,4,2,900,0,7,907,0
81,2,121,295,45,7,0,0,3,1,2,0,1,2,479,0,0,479,0
82,3,126,411,127,4,0,0,4,5,1,1,4,2,688,0,1,689,0
83,2,71,465,94,6,0,0,6,0,0,2,5,0,651,0,1,652,0
84,2,357,192,8,20,1,0,11,0,0,0,5,5,601,0,3,604,0
85,7,82,530,43,37,3,4,2,0,2,0,7,2,719,0,9,728,0
86,1,104,359,31,17,0,1,1,1,0,2,2,2,521,0,4,525,0
87,1,134,599,28,8,0,1,5,1,1,2,6,5,791,0,6,797,0
88,0,105,289,8,6,0,1,1,1,1,0,1,1,414,0,2,416,0
89,3,357,267,52,4,0,0,8,0,2,2,1,0,696,0,2,698,0
90,1,155,305,52,230,6,1,2,1,7,0,1,4,765,0,8,773,0
91,0,174,392,11,2,0,1,6,0,1,0,6,2,595,0,0,595,0
92,2,304,544,10,13,1,0,5,2,2,2,3,2,890,0,12,902,0
93,0,223,297,7,8,0,0,2,2,1,1,3,1,545,0,3,548,0
94,3,92,582,17,5,0,0,3,0,2,6,8,1,719,0,2,721,0
95,0,119,354,12,4,0,0,1,0,4,1,4,0,499,0,6,505,0
96,6,68,492,40,379,1,1,7,3,2,1,10,5,1015,0,18,1033,0
97,3,180,518,105,247,4,2,5,3,7,1,2,0,1077,0,4,1081,0
98,4,205,530,12,21,2,0,4,1,0,1,7,6,793,0,4,797,0
99,0,149,421,5,6,1,1,1,0,1,2,2,2,591,0,0,591,0
100,3,44,347,15,329,4,2,1,2,1,4,8,2,762,0,8,770,0
101,3,252,578,13,22,1,3,5,1,3,3,1,2,887,0,9,896,0
102,6,9,281,17,593,3,2,2,1,1,0,4,2,921,0,6,927,0
103,2,209,574,21,298,4,0,1,0,3,5,3,4,1124,0,2,1126,0
104,2,10,352,24,464,1,0,0,0,1,0,1,3,858,0,8,866,0
105,2,13,234,22,457,1,0,0,1,2,1,3,2,738,0,4,742,0
106,1,333,684,20,12,0,0,5,1,1,2,6,1,1066,0,3,1069,0
107,1,32,286,29,140,1,0,2,0,1,1,3,1,497,0,5,502,0
108,2,6,246,29,264,0,0,0,1,3,1,1,2,555,0,1,556,0
109,0,28,405,16,454,0,1,1,3,9,2,6,4,929,0,4,933,0
110,2,252,302,22,111,0,1,6,0,0,0,5,4,705,0,2,707,0
111,2,187,506,16,32,0,1,8,0,1,0,6,4,763,0,7,770,0
112,1,71,345,13,62,0,1,4,1,0,0,0,0,498,0,3,501,0
113,2,275,593,81,15,1,0,6,1,0,4,2,4,984,0,7,991,0
114,0,209,206,11,4,1,0,0,1,0,0,1,0,433,0,3,436,0
115,0,138,409,14,23,0,2,3,0,0,1,3,1,594,0,2,596,0
116,2,421,664,41,17,0,0,11,0,2,2,4,6,1170,0,4,1174,0
117,3,366,303,25,4,0,0,6,0,1,0,4,1,713,0,6,719,0
118,1,164,535,13,3,0,0,2,0,1,3,1,2,725,0,3,728,0
119,1,79,155,21,140,1,1,3,0,1,0,4,2,408,0,11,419,0
120,2,301,434,44,78,0,0,7,2,3,3,3,4,881,0,7,888,0
121,2,81,391,71,308,5,0,2,2,3,1,5,2,873,0,5,878,0
122,5,56,212,33,102,1,1,0,0,2,0,4,3,419,0,3,422,0
123,5,239,555,37,167,3,1,8,1,0,1,7,3,1027,0,12,1039,0
124,4,172,731,18,135,0,0,1,4,1,0,5,1,1072,0,3,1075,0
125,1,8,276,10,423,3,0,0,1,0,0,1,0,723,0,3,726,0
126,1,338,682,19,27,0,1,3,0,2,2,3,3,1081,0,3,1084,0
127,0,5,230,13,426,1,1,0,0,1,0,1,0,678,0,4,682,0
128,3,12,395,30,563,4,1,0,0,0,0,4,1,1013,0,5,1018,0
129,4,9,206,61,501,1,1,0,0,2,0,2,1,788,0,2,790,0
130,2,47,432,20,154,2,0,1,1,1,0,4,1,665,0,3,668,0
131,3,183,744,77,15,1,0,3,15,3,3,16,4,1067,0,6,1073,0
132,1,4,114,5,261,0,0,0,1,1,0,1,0,388,0,1,389,0
133,1,69,467,19,301,0,3,3,0,0,2,5,0,870,0,5,875,0
134,0,23,314,5,393,1,0,0,0,0,0,1,1,738,0,3,741,0
135,2,63,250,26,179,0,2,0,2,0,1,2,1,528,0,2,530,0
136,1,5,210,7,315,1,0,1,0,0,0,2,0,542,0,1,543,0
137,1,9,300,18,655,3,0,2,0,3,1,4,2,998,0,7,1005,0
138,5,153,564,85,22,0,2,4,1,0,4,8,1,849,0,6,855,0
139,5,108,341,100,229,1,0,1,1,2,2,6,0,796,0,4,800,0
140,3,23,568,17,315,2,0,0,3,2,1,4,1,939,0,4,943,0
141,0,10,195,4,351,2,1,0,0,4,1,6,1,575,0,5,580,0
142,4,117,784,53,19,1,0,3,1,2,3,2,1,990,0,3,993,0
143,1,4,194,34,550,1,1,3,2,3,2,2,3,800,0,3,803,0
144,0,71,584,33,80,0,0,0,0,1,3,2,4,778,0,9,787,0
145,1,105,554,64,210,4,2,2,1,0,1,5,0,949,0,7,956,0
146,0,1,105,10,283,1,1,1,1,3,0,0,0,406,0,4,410,0
147,3,6,281,8,499,4,0,1,2,1,0,4,1,810,0,4,814,0
       14S,1,49,249,18,320,0,0,1,0,3,3,1,0,645,0,6,651,0
149,1,58,523,42,66,2,0,0,0,1,2,7,1,703,0,3,706,0
150,0,30,209,13,270,1,0,1,0,1,0,1,0,526,0,2,528,0
151,4,240,793,24,51,1,2,0,1,0,0,5,0,1121,0,2,1123,0
152,1,11,235,32,415,5,0,0,1,1,0,5,1,707,0,2,709,0
153,6,2,229,16,402,2,1,2,0,2,3,3,1,669,0,4,673,0
154,1,7,290,23,203,1,0,1,0,0,0,5,0,531,0,1,532,0
155,0,228,704,25,10,2,0,5,0,1,1,8,7,991,0,5,996,0
156,4,251,672,30,18,1,4,2,0,1,1,9,4,997,0,6,1003,0
157,0,54,466,6,43,0,1,0,0,0,1,5,0,576,0,1,577,0
158,2,419,473,19,11,0,0,2,0,1,0,4,1,932,0,3,935,0
159,0,54,306,1,39,0,0,0,0,0,0,4,0,404,0,3,407,0
160,1,221,540,23,16,2,0,10,0,1,0,7,1,822,0,3,825,0
161,3,446,590,49,13,4,2,6,1,4,3,10,6,1137,0,5,1142,0
162,2,180,647,70,10,2,0,4,0,0,0,5,2,922,0,2,924,0
163,3,7,205,16,721,5,0,0,3,13,0,2,4,979,0,6,985,0
164,0,70,516,3,4,1,1,0,1,0,1,5,0,602,0,3,605,0
165,2,231,410,15,38,2,0,4,0,0,1,1,0,704,0,3,707,0
166,0,194,390,4,6,0,1,2,0,2,0,6,2,607,0,0,607,0
167,2,47,331,16,331,0,0,1,0,2,1,4,0,735,0,2,737,0
158,0,263,566,22,202,0,0,1,2,4,2,13,4,1079,0,9,1088,0
169,1,86,380,12,287,0,1,2,2,3,6,4,1,785,0,5,790,0
170,3,100,503,6,3,1,0,0,1,0,0,2,0,619,0,4,623,0
171,0,179,699,21,4,1,1,3,1,0,2,7,2,920,0,1,921,0
172,1,279,523,89,7,1,2,1,0,0,1,3,5,912,0,2,914,0
173,1,119,502,73,76,2,0,0,1,1,1,3,2,781,0,3,784,0
174,0,173,506,103,130,1,3,5,1,1,0,5,0,928,0,6,934,0
175,6,150,714,24,59,3,0,1,0,6,1,5,6,975,0,12,987,0
176,2,88,432,32,5,0,0,1,0,0,1,7,0,568,0,3,571,0
177,2,275,315,14,51,0,1,5,0,0,2,2,2,669,0,8,677,0
178,2,260,601,20,13,1,3,4,0,2,2,5,2,915,0,2,917,0
179,4,85,468,21,184,5,0,3,0,2,1,2,2,777,0,3,780,0
180,3,110,691,257,16,0,0,5,1,2,1,3,0,1089,0,4,1093,0
181,0,263,384,32,4,0,0,0,1,0,0,1,0,685,0,3,688,0
182,1,9,609,4,23,1,0,0,0,0,0,2,0,649,0,0,649,0
183,2,221,623,41,9,1,0,1,0,0,0,0,2,900,0,1,901,0
184,0,222,529,59,17,0,0,0,0,0,0,2,1,830,0,3,833,0
185,1,213,583,57,10,1,0,2,0,2,1,2,3,875,0,2,877,0
186,7,16,255,31,464,4,3,2,2,10,6,11,9,820,0,15,835,0
187,3,8,260,23,580,0,0,1,1,1,2,3,4,886,0,2,888,0
188,7,4,219,9,220,3,3,1,1,2,1,4,6,480,0,9,489,0
189,0,41,228,8,155,1,0,0,3,1,4,3,3,447,0,1,448,0
190,5,110,602,21,140,1,0,3,0,4,2,14,1,903,0,2,905,0
191,0,94,927,13,11,0,1,4,2,0,2,2,0,1056,0,2,1058,0
192,5,60,391,26,211,1,1,3,3,5,3,6,1,716,0,5,721,0
193,0,97,352,21,3,0,0,3,0,2,0,2,1,481,0,1,482,0
194,1,27,252,3,84,1,0,0,1,1,1,1,1,373,0,4,377,0
195,5,133,601,36,326,3,2,3,0,3,4,12,4,1132,0,7,1139,0
196,2,33,378,51,364,5,4,3,1,3,4,10,10,868,0,25,893,0
197,2,150,376,35,211,3,0,2,0,1,0,3,2,785,0,4,789,0
198,3,131,402,41,219,2,1,1,0,1,3,4,2,810,0,8,818,0
199,1,163,324,42,217,4,1,3,0,2,1,2,1,761,0,3,764,0
200,1,43,856,15,1,0,0,1,1,0,0,2,0,920,0,0,920,0
201,0,68,559,21,3,0,0,2,0,1,0,3,1,658,0,3,661,0
202,0,24,550,11,4,0,0,0,0,0,0,1,0,590,0,0,590,0
203,0,304,523,72,7,0,1,3,0,0,5,4,2,921,0,2,923,0
204,2,186,511,67,8,0,0,2,0,0,1,1,1,779,0,5,784,0
205,3,202,641,57,3,0,0,1,1,0,0,2,1,911,0,1,912,0
206,2,56,829,98,17,1,2,1,2,0,6,12,2,1028,0,7,1035,0
207,0,17,721,13,7,0,0,0,0,1,0,2,0,761,0,0,761,0
208,0,13,777,8,4,1,0,0,0,0,0,4,0,807,0,1,808,0
209,3,21,602,26,350,2,3,0,0,2,7,11,6,1033,0,12,1045,0
210,1,7,668,12,5,0,0,0,1,0,0,5,1,700,0,1,701,0
211,0,33,661,28,6,1,1,0,0,1,1,7,2,741,0,2,743,0
212,1,11,879,3,4,0,0,0,0,0,0,1,6,905,0,0,905,0
213,2,3,872,11,26,0,0,0,0,0,0,0,0,914,0,0,914,0
214,1,4,975,0,0,0,0,4,1,0,2,0,3,990,0,2,992,0
215,1,12,291,30,276,1,0,0,1,1,2,3,0,618,0,2,620,0
216,3,11,351,18,359,4,4,2,0,3,4,4,6,769,0,10,779,0
217,0,49,510,82,304,4,0,1,1,5,2,6,5,969,0,10,979,0
218,2,34,388,25,258,3,2,0,0,2,4,6,6,730,0,4,734,0
219,0,18,395,24,289,0,0,2,0,2,5,4,2,741,0,4,745,0
220,0,49,678,23,1,0,0,0,1,0,1,1,0,754,0,1,755,0
221,3,107,599,28,5,1,0,0,0,0,0,2,0,745,0,6,751,0
222,1,4,164,28,252,0,0,1,2,0,1,0,0,453,0,1,454,0
223,0,3,181,4,335,4,1,0,0,2,2,1,2,535,0,3,538,0
224,2,0,114,12,293,0,0,0,0,2,2,2,0,427,0,2,429,0
225,2,20,292,24,294,2,1,1,0,4,0,6,1,647,0,2,649,0
226,2,27,392,64,212,1,0,0,0,1,2,7,0,708,0,6,714,0
227,5,23,352,52,337,3,2,4,0,4,0,9,8,799,0,8,807,0
228,1,7,275,6,328,1,0,2,1,8,2,5,4,640,0,8,648,0
229,3,10,200,21,365,0,0,0,2,2,0,3,1,607,0,4,611,0
0.23,3,28,645,113,237,7,4,2,5,2,4,15,3,1068,0,5,1073,0
231,1,43,746,22,26,1,1,2,0,0,1,3,1,847,0,2,849,0
232,3,33,862,16,44,6,0,2,1,2,1,5,7,982,0,3,985,0
233,2,41,793,21,12,0,1,0,1,0,2,5,1,879,0,2,881,0
234,2,50,876,22,24,0,0,0,0,1,0,3,0,978,0,2,980,0
235,1,39,439,17,172,0,0,0,2,0,0,2,0,672,0,2,674,0
236,1,39,642,9,9,0,0,0,0,0,3,6,3,712,0,2,714,0
237,1,21,784,20,19,1,0,0,0,0,1,5,2,854,0,8,862,0
238,3,105,911,48,14,2,1,3,0,0,2,4,4,1097,0,4,1101,0
239,2,31,411,14,125,1,0,1,0,3,1,3,1,593,0,4,597,0
240,3,28,572,188,82,0,0,4,0,0,6,5,3,891,0,7,898,0
241,1,17,643,16,270,2,0,0,0,7,3,6,9,974,0,8,982,0
242,1,53,318,21,37,1,1,1,0,0,3,7,0,443,0,1,444,0
243,0,74,417,44,22,0,1,2,0,1,0,5,0,566,0,2,568,0
244,5,17,321,18,300,3,0,1,2,3,1,4,3,678,0,5,683,0
245,1,236,724,43,11,0,1,5,1,0,0,3,1,1026,0,4,1030,0
246,9,238,816,114,18,0,1,3,4,2,4,20,2,1031,0,8,1039,0
247,2,140,509,37,11,0,2,2,0,1,0,6,0,710,0,1,711,0
248,1,65,529,22,368,1,0,0,0,1,0,4,1,992,0,5,997,0
249,1,57,810,8,17,0,1,2,0,0,0,0,0,896,0,0,896,0
250,2,114,394,13,10,0,0,1,0,2,2,1,1,540,0,1,541,0
251,2,75,464,20,110,0,0,1,0,0,2,7,4,685,0,3,688,0
252,2,148,675,31,137,2,1,2,1,1,1,10,1,1012,0,11,1023,0
253,3,145,481,19,144,2,2,5,2,3,5,12,5,828,0,9,837,0
254,3,140,453,11,1,2,1,1,0,0,1,1,1,615,0,1,616,0
255,0,84,543,17,323,2,1,3,1,1,2,4,3,984,0,6,990,0
256,0,2,304,6,272,2,0,3,2,0,1,1,0,593,0,4,597,0
257,3,82,794,26,89,0,1,4,1,0,0,2,0,1002,0,4,1006,0
258,1,3,138,13,443,3,0,1,2,3,1,2,1,611,0,1,612,0
259,1,0,140,6,502,4,2,0,1,6,0,1,5,668,0,4,672,0
260,1,3,434,15,451,6,0,0,1,0,2,4,3,920,0,4,924,0
261,0,2,562,7,100,2,0,1,0,0,3,3,0,680,0,1,681,0
262,0,3,568,4,1,0,0,0,0,0,0,2,0,578,0,1,579,0
263,1,64,626,32,40,0,0,2,0,0,0,5,3,773,0,0,773,0
264,1,62,693,6,36,0,0,0,0,1,1,4,0,804,0,0,804,0
265,1,99,645,20,7,0,0,3,0,0,1,8,1,785,0,5,790,0
266,1,87,805,69,6,2,0,2,0,1,2,9,1,985,0,7,992,0
267,3,18,504,35,482,0,3,1,1,3,1,5,0,1056,0,4,1060,0
268,3,3,150,5,449,3,0,0,1,2,3,1,1,621,0,5,626,0
269,2,39,457,18,234,1,2,1,0,4,2,10,1,771,0,9,     ÃÂ·780,0
270,0,37,377,14,44,0,0,2,0,0,0,2,2,478,0,7,485,0
271,3,15,305,16,282,0,0,0,1,5,0,4,1,632,0,5,637,0
272,2,27,672,19,22,1,0,0,0,0,0,8,2,753,0,1,754,0
273,2,261,533,16,78,4,0,4,1,4,3,7,4,917,0,11,928,0
274,0,305,440,32,156,3,1,1,1,0,4,10,3,956,0,11,967,0
275,0,43,794,17,120,0,1,1,0,1,0,2,0,979,0,2,981,0
276,0,59,825,35,82,1,0,0,0,0,1,8,1,1012,0,3,1015,0
277,1,4,108,22,537,3,3,0,0,2,0,1,1,682,0,2,684,0
278,2,47,420,10,49,0,0,1,0,1,1,5,0,536,0,1,537,0
279,2,26,422,28,177,1,0,1,0,1,2,2,0,662,0,1,663,0
280,0,12,279,4,289,2,0,0,1,3,3,4,3,600,0,1,601,0
281,2,3,201,10,409,2,1,2,1,5,1,4,1,642,0,4,646,0
282,2,2,166,3,462,3,1,2,2,5,2,9,2,661,0,6,667,0
283,1,8,167,13,427,3,0,0,1,1,0,6,2,629,0,14,643,0
1,1,1,634,6,171,1,0,0,1,2,0,7,0,                  S24,0,4,828,0
2,1,2,657,6,146,1,0,0,0,3,0,15,3,834,0,8,842,0
3,2,3,466,2,105,4,3,0,1,1,5,22,2,616,0,2,618,0
4,0,1,556,6,76,1,0,0,0,1,0,6,2,649,0,3,652,0
6,1,6,481,1,56,0,0,0,0,2,1,5,2,555,0,3,558,0
6,0,4,638,2,20,0,0,0,0,0,0,2,0,666,0,0,666,0
7,0,5,762,9,51,1,0,2,0,1,2,11,1,845,0,1,                   B46,0
8,1,1,591,6,95,0,0,0,0,0,0,2,0,696,0,1,697,0
9,0,3,496,5,146,1,0,1,0,0,1,2,1,656,0,6,662,0
10,8,2,421,4,119,3,1,0,0,1,0,6,3,568,0,5,573,0
11,5,1,543,6,53,1,1,0,0,2,0,6,2,620,0,2,622,0
12,3,5,296,10,477,4,1,3,3,8,5,14,3,832,0,13,845,0
13,5,4,236,11,374,4,1,1,1,7,2,7,6,659,0,13,672,0
14,3,6,218,22,711,4,0,1,0,4,4,8,3,984,0,5,989,0
15,0,11,272,12,372,1,0,0,1,6,0,0,1,676,0,4,680,0
16,1,1,173,8,235,5,0,0,0,2,0,7,0,432,0,3,435,0
17,2,3,291,11,457,6,1,1,2,8,3,14,1,800,0,4,804,0
18,1,6,241,11,718,1,0,2,1,5,0,7,4,997,0,4,1001,0
19,1,2,274,6,500,1,1,1,2,9,1,8,2,808,0,6,814,0
20,2,2,248,13,610,2,0,1,0,6,3,2,0,889,0,2,891,0
21,0,5,208,13,448,4,2,0,1,6,0,6,1,694,0,2,696,0
22,2,4,113,11,271,1,1,1,0,1,1,1,1,408,0,5,413,0
23,0,14,532,35,89,2,0,1,0,1,2,8,0,684,0,3,687,0
24,2,13,345,44,395,4,0,1,0,1,0,4,1,810,0,3,813,0
25,0,20,551,11,112,1,1,3,1,2,1,9,1,713,0,5,718,0
26,1,3,271,24,394,0,0,0,0,5,1,8,1,708,0,5,713,0
27,4,11,509,70,242,0,0,0,0,2,4,10,1,853,0,10,863,0
28,6,5,494,14,447,6,0,0,0,8,1,9,2,992,0,7,999,0
29,0,1,95,2,274,2,1,1,2,1,0,1,0,381,0,0,381,0
30,4,8,567,46,305,1,1,1,2,5,3,13,6,962,0,9,971,0
31,1,3,181,17,488,6,0,1,0,2,0,1,0,700,0,5,705,0
32,1,4,472,11,389,1,1,0,2,2,0,9,0,892,0,11,903,0
33,4,23,494,164,266,2,1,0,2,2,0,1,1,960,0,3,963,0
34,0,20,354,16,153,0,1,0,0,0,2,5,0,551,0,2,553,0
35,2,25,571,67,256,3,0,3,0,5,2,4,7,946,0,8,954,0
36,1,6,412,98,173,1,3,0,3,1,4,12,4,718,0,15,733,0
37,1,4,233,21,286,0,0,0,2,0,0,6,3,556,0,2,558,0
38,1,2,246,11,377,0,0,1,0,6,2,7,0,653,0,9,662,0
39,1,14,513,88,203,2,2,1,0,2,2,4,2,834,0,5,839,0
40,0,0,0,0,0,0,0,0,0,0,0,0,0,0,0,0,0,0
41,2,14,470,82,17,0,1,0,1,1,0,4,1,593,0,2,595,0
42,4,25,507,70,25,0,1,1,1,0,1,3,1,639,0,9,644,0
43,2,23,759,39,153,2,2,0,2,1,0,9,2,994,0,10,1004,0
44,3,23,1043,52,11,0,0,2,1,0,1,2,2,1140,0,7,1147,0
45,2,27,780,70,12,1,0,0,0,1,1,11,0,905,0,4,909,0
46,1,13,484,54,142,2,0,0,1,2,4,4,3,710,0,5,715,0
47,3,2,134,5,400,4,1,1,1,4,1,2,4,562,0,4,566,0
48,0,2,177,27,314,2,1,0,1,4,2,3,2,535,0,2,537,0
49,5,37,574,51,92,1,0,1,0,1,2,12,1,777,0,5,782,0
50,3,7,355,10,456,1,1,1,2,2,4,5,3,850,0,9,859,0
51,0,139,649,49,84,3,2,1,0,1,3,5,0,935,0,4,939,0
52,3,43,803,58,61,0,0,1,2,                 a,1,15,3,992,0,8,1000,0
53,1,121,890,76,11,0,1,7,0,2,2,8,0,1119,0,5,1124,0
54,0,12,368,27,51,1,0,1,2,0,0,4,0,466,0,0,466,0
55,1,28,688,124,41,2,2,3,1,0,4,7,1,902,0,9,911,0
56,0,0,133,1,243,0,1,0,0,1,0,1,2,382,0,2,384,0
57,4,4,286,9,245,3,2,1,1,3,1,3,0,562,0,1,563,0
58,1,66,670,39,9,1,0,2,0,0,2,4,0,794,0,2,796,0
59,7,74,754,35,62,0,0,2,0,3,1,5,1,944,0,3,947,0
60,2,40,482,159,135,2,2,2,7,2,2,7,3,845,0,6,851,0
61,0,6,798,7,12,0,0,0,0,0,1,1,0,825,0,0,825,0
62,1,2,119,13,208,1,0,2,0,6,0,6,0,358,0,4,362,0
63,2,52,717,10,9,0,0,0,0,0,1,14,0,805,0,8,813,0
64,1,3,168,9,394,2,1,1,0,1,1,3,4,588,0,2,590,0
65,2,8,545,3,181,0,0,1,0,0,1,0,1,742,0,3,745,0
66,5,4,950,8,52,2,1,0,0,4,1,15,0,1042,0,9,1051,0
67,0,2,1026,2,8,0,0,0,0,0,1,3,1,1043,0,1,1044,0
68,6,6,541,3,128,2,0,1,0,0,2,9,2,700,0,7,707,0
69,0,11,612,6,1,2,0,0,0,0,0,1,0,633,0,0,633,0
70,2,16,1073,6,22,0,0,1,0,0,1,8,3,1132,0,3,1135,0
71,0,3,1028,7,11,0,0,0,0,0,2,3,1,1055,0,0,1055,0
72,3,2,862,5,14,0,0,0,0,0,1,0,0,887,0,1,888,0
73,0,2,796,1,3,0,0,0,1,0,0,4,1,808,0,2,810,0
74,0,0,0,0,0,0,0,0,0,0,0,0,0,0,0,0,0,0
75,3,2,654,7,108,3,0,0,1,2,1,4,1,785,0,1,786,0
76,3,1,532,4,197,3,0,1,1,2,0,2,1,747,0,4,751,0
77,3,2,327,6,307,1,0,0,0,4,1,5,1,657,0,3,660,0
78,0,4,217,13,554,5,1,1,1,5,4,2,3,810,0,6,816,0
79,3,7,404,53,489,4,1,0,2,2,1,0,0,966,0,6,972,0
80,1,4,289,3,309,2,0,0,0,3,0,2,2,615,0,0,615,0
                            B1,1,1,445,9,534,2,0,1,0,2,1,4,3,1003,0,1,1004,0
82,4,3,266,29,461,7,0,0,3,2,1,2,7,785,0,9,794,0
83,4,5,322,20,340,2,1,1,0,1,2,5,6,709,0,5,714,0
84,3,4,371,85,55,0,0,0,0,0,1,5,0,524,0,1,525,0
85,6,3,285,14,289,1,3,0,0,0,2,1,1,605,0,8,613,0
86,4,6,214,19,429,3,1,2,2,5,4,1,3,693,0,5,698,0
87,3,3,414,22,408,0,1,2,0,3,3,6,2,867,0,9,876,0
88,4,7,245,6,182,4,1,0,1,3,1,2,0,456,0,4,460,0
89,1,7,273,12,214,1,0,0,0,1,0,0,2,511,0,4,515,0
90,5,2,353,29,396,4,2,0,2,2,4,0,4,803,0,5,808,0
91,5,11,459,25,549,7,0,0,0,0,2,5,5,1068,0,7,1075,0
92,0,3,160,7,262,3,1,0,0,2,1,1,1,441,0,1,442,0
93,4,3,229,3,287,3,1,0,1,2,1,1,4,539,0,5,544,0
94,1,1,200,2,236,3,0,1,0,1,0,1,2,448,0,2,450,0
95,0,4,223,7,301,2,0,1,1,2,1,4,0,546,0,2,548,0
96,6,6,348,17,499,2,2,2,1,1,4,3,0,891,0,2,893,0
97,0,1,149,8,397,4,0,0,0,0,4,1,0,564,0,4,568,0
98,3,29,596,68,113,2,3,0,2,3,1,5,2,827,0,0,827,0
99,2,25,721,96,65,2,0,0,0,1,4,9,1,926,0,6,932,0
100,1,2,200,19,459,0,0,1,0,2,1,1,1,687,0,3,690,0
101,1,4,291,26,372,2,0,0,0,0,2,4,0,702,0,4,706,0
102,4,10,255,11,248,2,2,1,0,2,1,3,0,539,0,1,540,0
103,2,2,397,18,382,1,0,0,1,2,2,3,2,812,0,3,815,0
104,0,3,243,23,283,2,0,0,0,1,0,0,1,556,0,4,560,0
105,4,2,139,24,352,1,0,0,0,3,2,3,3,533,0,5,538,0
106,3,4,231,23,289,0,2,2,1,6,2,2,3,568,0,4,572,0
107,2,12,222,38,630,3,1,3,1,2,0,6,4,924,0,5,929,0
108,4,5,215,45,672,5,1,1,3,9,2,3,2,967,0,8,975,0
109,1,3,181,4,320,4,0,0,0,3,0,3,0,519,0,2,521,0
110,1,20,672,127,64,0,5,1,1,0,1,4,2,898,0,2,900,0
111,3,12,320,30,374,1,1,1,1,0,1,2,3,749,0,5,754,0
112,2,9,271,55,365,3,1,1,1,0,1,0,1,710,0,4,714,0
113,3,3,299,33,127,1,2,0,1,0,1,1,5,477,0,1,478,0
114,2,16,642,117,49,0,1,0,0,0,2,0,1,830,0,1,831,0
115,3,5,361,22,444,9,0,0,0,2,2,7,1,856,0,5,861,0
116,3,14,640,95,144,1,2,0,1,3,5,6,3,917,0,3,920,0
117,0,10,615,77,71,1,0,0,0,1,6,4,7,792,0,10,802,0
118,3,11,672,44,70,1,1,2,1,0,2,8,1,816,0,4,820,0
119,2,6,181,25,347,2,2,1,1,4,0,3,1,575,0,5,580,0
120,2,17,702,22,11,1,0,1,2,1,2,9,1,771,0,6,777,0
121,5,10,510,33,101,1,0,0,0,0,0,1,1,662,0,4,666,0
122,2,1,277,6,179,3,0,0,0,0,1,3,7,479,0,2,481,0
123,6,7,289,26,284,0,1,2,1,5,3,7,2,633,0,3,636,0
124,4,4,238,17,308,1,2,2,1,0,4,4,3,588,0,5,593,0
125,4,6,                                4-95,23,313,3,1,0,2,1,1,7,4,860,0,3,863,0
126,3,7,369,20,530,7,0,2,1,6,1,5,3,954,0,0,954,0
127,2,7,490,31,273,5,1,0,1,5,4,8,4,831,0,6,837,0
128,7,4,290,42,572,3,3,1,                    i,4,1,7,4,939,0,10,949,0
129,1,1,146,7,248,3,0,0,0,2,0,2,3,413,0,2,415,0
130,1,4,246,10,355,5,0,1,0,1,0,2,1,626,0,3,629,0
131,3,2,163,15,353,3,1,1,0,2,3,3,2,551,0,6,557,0
132,18,1,269,39,313,5,0,2,0,2,1,5,2,657,0,7,664,0
133,2,3,219,13,239,2,0,0,1,4,1,2,0,486,0,4,490,0
134,5,8,419,23,291,2,0,0,1,1,0,6,1,757,0,0,757,0
135,0,4,261,23,385,6,2,0,1,2,1,6,3,694,0,5,699,0
136,4,5,202,22,411,2,0,0,2,0,1,0,2,651,0,1,652,0
137,1,2,185,31,360,2,1,0,0,1,2,0,1,586,0,1,587,0
138,5,1,216,42,405,9,0,0,2,2,0,3,0,685,0,8,693,0
139,6,5,274,                            g,275,1,1,0,1,0,3,1,1,577,0,1,578,0
140,3,3,309,31,438,2,1,1,0,2,2,4,0,796,0,10,806,0
141,2,3,176,11,227,4,1,1,0,1,1,3,1,431,0,2,433,0
142,1,2,200,61,315,2,1,1,0,1,1,0,5,590,0,7,597,0
143,2,4,119,21,336,4,0,0,0,3,1,11,4,505,0,1,506,0
144,0,1,137,17,274,1,0,0,0,2,2,3,2,439,0,3,442,0
145,6,5,265,33,312,6,0,0,0,2,1,1,0,631,0,2,633,0
146,2,3,283,7,430,3,2,3,4,11,5,5,4,762,0,12,774,0
147,2,5,434,17,451,3,3,1,                 s,8,4,10,1,944,0,5,949,0
148,4,0,327,9,565,4,0,0,1,2,1,4,2,919,0,7,926,0
149,3,3,395,42,566,9,0,2,1,3,0,2,1,1027,0,5,1032,0
150,1,6,302,16,276,2,0,0,0,1,1,3,3,611,0,4,615,0
151,1,6,194,8,240,3,3,0,0,2,2,3,2,464,0,7,471,0
152,0,1,245,9,360,1,0,3,0,0,2,2,3,626,0,3,629,0
153,2,0,435,13,256,0,1,0,0,0,2,3,3,715,0,3,718,0
154,2,1,160,4,177,0,0,1,1,0,0,2,0,348,0,3,351,0
155,1,3,326,13,313,3,0,0,1,,0,3,0,664,0,2,666,0
156,2,4,273,7,385,6,1,1,0,3,4,6,6,698,0,8,706,0
157,0,0,295,5,337,1,0,0,0,1,0,2,0,641,0,1,642,0
158,3,3,453,13,475,3,1,2,3,3,0,6,5,970,0,5,975,0
159,3,0,                          34S,3,99,0,3,0,0,0,0,3,1,460,0,1,461,0
160,5,3,437,20,379,4,2,0,1,2,1,14,4,872,0,2,874,0
161,1,2,214,9,334,3,1,0,1,4,5,10,3,587,0,5,592,0
162,3,1,272,15,524,1,1,2,2,3,3,4,1,833,0,7,840,0
163,9,5,563,13,                          3S6,5,4,1,1,5,4,5,4,1005,0,5,1010,0
164,3,                           S,292,10,325,3,0,0,0,1,0,0,0,642,0,3,645,0
165,2,1,159,3,221,1,2,0,0,0,0,3,1,393,0,6,399,0
166,3,9,341,14,446,6,0,0,1,1,1,0,0,822,0,3,825,0
167,5,5,461,17,432,2,0,1,1,4,0,6,3,937,0,7,944,0
                           16B,2,8,272,31,363,3,0,0,1,1,0,1,1,633,0,10,693,0
169,0,3,255,12,208,2,1,1,0,0,1,0,0,483,0,3,486,0
170,0,5,314,26,177,3,1,0,0,1,2,15,1,545,0,5,550,0
171,4,4,614,7,173,1,0,1,0,1,1,11,0,817,0,4,821,0
172,1,1,423,9,99,0,1,0,0,0,1,5,1,541,0,4,545,0
173,3,7,400,8,132,0,0,1,0,1,3,10,5,570,0,2,572,0
174,1,3,359,8,378,2,2,2,1,4,1,9,3,773,0,6,779,0
175,3,9,350,10,411,6,0,0,1,0,1,11,10,812,0,8,820,0
176,6,2,508,13,346,1,3,2,1,4,8,20,3,917,0,12,929,0
177,5,8,511,10,230,0,0,1,0,2,2,1,5,775,0,6,781,0
178,7,7,572,30,445,3,0,1,0,8,2,9,7,1091,0,3,1094,0
179,0,4,276,28,366,3,3,0,0,2,4,15,11,712,0,10,722,0
180,1,2,377,27,342,4,0,1,0,3,0,5,7,769,0,5,774,0
181,1,5,394,13,136,0,2,0,0,0,0,1,1,553,0,1,554,0
                   J.82,7,3,409,18,520,8,2,0,1,4,2,12,5,991,0,                   S,999,0
183,3,10,309,22,539,6,1,1,2,4,2,18,7,924,0,9,933,0
184,2,4,279,10,399,5,0,0,1,2,5,4,5,716,0,3,719,0
185,8,9,342,11,289,4,1,0,0,1,3,3,5,676,0,5,681,0
186,4,9,408,13,319,3,1,4,1,2,1,7,2,774,0,8,782,0
187,0,4,366,17,359,1,1,0,1,2,0,6,4,761,0,6,767,0
188,1,0,130,4,103,0,,0,1,0,0,1,1,241,0,0,241,0
189,5,9,371,12,417,4,1,1,0,1,3,9,5,838,0,14,852,0
190,3,3,341,39,262,3,1,0,0,3,0,3,1,659,0,2,661,0
191,4,6,263,17,213,2,1,0,1,0,0,1,1,509,0,4,513,0
192,3,1,259,17,231,1,1,0,0,0,1,0,0,514,0,0,514,0
193,6,2,364,56,404,3,4,0,1,7,2,7,5,861,0,5,866,0
194,4,8,333,42,605,1,1,1,3,0,2,6,4,910,0,8,918,0
195,4,4,291,26,444,5,2,0,3,5,3,6,3,796,0,7,803,0
196,2,13,307,33,166,2,0,2,0,0,0,3,1,529,0,6,535,0
197,2,8,382,14,270,2,0,0,2,6,2,6,3,697,0,9,706,0
198,2,6,297,16,249,2,0,0,0,3,0,2,0,577,0,3,580,0
199,4,3,269,3,316,1,0,0,0,1,1,2,3,603,0,5,608,0
200,3,4,399,11,496,7,3,0,2,3,7,3,3,941,0,5,946,0
201,1,1,264,5,330,5,0,0,0,1,3,5,1,616,0,3,619,0
202,5,10,476,31,284,3,0,1,0,2,1,2,1,816,0,2,818,0
203,4,6,                  34b,10,396,5,4,0,1,3,3,5,0,782,0,6,788,0
204,3,4,385,27,390,4,2,3,0,3,0,1,3,825,0,11,836,0
205,1,0,250,29,159,1,0,0,0,1,0,2,1,444,0,2,446,0
206,3,5,296,11,300,5,4,0,0,3,3,5,2,637,0,7,644,0
207,2,6,343,22,314,6,1,1,0,2,0,3,2,702,0,2,704,0
208,6,9,300,26,389,3,1,2,1,0,1,3,2,743,0,7,750,0
209,3,6,198,31,248,0,0,0,2,2,3,2,4,499,0,3,502,0
210,3,2,272,32,321,3,0,0,1,0,0,3,1,638,0,4,642,0
211,3,7,274,25,372,3,0,1,0,2,1,0,0,688,0,11,699,0
212,3,3,425,43,344,1,2,3,1,2,2,1,1,831,0,9,840,0
213,2,19,520,65,69,3,1,2,0,5,0,6,1,693,0,7,700,0
214,3,6,389,21,347,2,1,2,1,1,0,1,2,776,0,5,781,0
215,1,1,225,12,206,0,1,0,0,1,2,0,0,449,0,0,449,0
216,3,1,315,8,317,1,1,0,0,1,2,1,3,653,0,2,655,0
217,0,0,165,11,213,3,1,0,1,1,0,1,1,397,0,1,398,0
218,3,12,274,13,110,1,0,0,0,1,3,3,1,421,0,4,425,0
219,2,2,235,28,243,1,0,0,0,3,1,5,3,523,0,1,524,0
220,0,9,291,18,218,0,0,0,0,0,1,0,3,540,0,1,541,0
221,9,8,288,12,277,2,0,0,0,0,0,3,2,601,0,1,602,0
222,1,0,151,22,328,2,1,0,1,0,1,8,2,517,0,7,524,0
223,2,3,203,16,356,8,1,0,1,2,4,5,5,606,0,11,617,0
224,3,4,340,12,607,7,3,0,1,6,4,3,4,994,0,9,1003,0
225,4,2,166,12,327,2,1,1,0,6,3,6,3,533,0,1,534,0
226,1,3,331,23,377,8,1,0,0,3,                       X,4,5,757,0,6,763,0
227,0,4,124,37,310,4,0,0,0,0,1,2,1,483,0,2,485,0
228,1,6,274,35,314,2,0,0,0,2,3,6,1,644,0,4,648,0
229,0,0,234,7,430,5,1,0,2,0,2,1,8,690,0,4,694,0
230,1,2,271,16,230,2,1,0,0,1,1,2,2,529,0,4,533,0
231,1,2,218,17,275,1,0,1,1,3,2,1,3,525,0,6,531,0
232,7,3,397,11,288,3,1,1,1,1,2,10,5,730,0,7,737,0
233,1,2,319,21,518,3,1,1,0,2,3,34,4,909,0,8,917,0
234,1,2,223,11,237,3,0,0,0,0,1,1,0,479,                   c,4,483,0
235,2,2,353,22,390,3,0,0,0,0,0,7,6,785,0,5,790,0
236,1,4,368,9,332,0,1,1,0,1,2,17,4,740,0,6,746,0
237,3,1,326,5,227,1,0,0,0,0,0,25,1,589,0,3,592,0
233,4,2,297,5,375,2,1,1,0,2,0,14,1,704,0,4,708,0
239,2,1,242,9,248,8,0,0,1,2,2,11,4,530,0,1,531,0
                                  2A0,2,1,292,28,229,3,0,0,2,1,1,2,1,562,0,1,563,0
241,1,3,221,14,290,2,1,3,0,0,1,3,2,541,0,1,542,0
242,3,3,390,17,500,3,0,0,0,2,2,4,2,926,0,4,930,0
243,1,6,411,15,466,5,0,1,0,2,2,5,1,915,0,9,924,0
244,4,2,429,45,354,4,1,0,0,2,0,4,4,849,0,6,855,0
245,3,2,414,25,453,6,3,0,0,3,1,7,0,917,0,6,923,0
246,1,5,426,28,467,3,0,0,0,2,1,1,0,934,0,2,936,0
247,0,7,364,28,467,5,1,2,1,1,0,5,4,885,0,5,890,0
248,2,2,264,7,341,5,0,0,0,2,2,4,3,632,0,1,633,0
249,1,2,446,45,521,1,1,0,0,2,2,0,1,1022,0,7,1029,0
250,2,4,388,13,434,3,0,0,1,3,0,3,1,852,0,4,856,0
251,3,5,323,8,292,3,0,0,0,0,1,2,1,638,0,2,640,0
252,0,6,350,13,296,1,1,1,1,0,3,4,0,676,0,3,679,0
253,              A,9,425,17,475,4,1,1,3,3,3,9,4,958,0,5,963,0
254,              i.,4,381,10,239,1,2,0,0,1,4,2,4,649,0,2,651,0
40,5,13,402,22,531,1,0,0,1,7,2,12,0,996,0,5,1001,0
74,1,5,634,11,286,8,1,2,1,2,2,16,5,974,0,1,975,0
