No. of Polling <:tatinn.1,CHANDRA KUMAR BOSE,MALA ROY,MITA CHAKRABOR TV,NANDINI MUKHERJEE,sarfaraz KHAN,DEBABRA TA BERA,SRIDHAR CHANDRA BAGRI,BADAL MONDAL,GAUTAM MITRA,KASHINATH DAS,NIRAJ AGARWAL,RITA DUTTA,SANTANU ROY,Valid Votes,Rejected Votes,NOTA,Total,Tender* d Votes
1,169,195,43,27,3,0,3,1,1,0,0,2,3,447,0,9,456,0
2,348,363,14,49,1,0,1,0,0,2,5,2,6,791,0,4,795,0
3,68,96,38,5,0,1,1,0,1,0,1,1,1,213,0,9,222,0
4,29,791,52,46,2,0,0,1,1,0,2,1,8,933,0,7,940,0
5,24,897,68,35,3,1,0,0,2,0,1,3,2,1036,0,7,1043,0
6,21,971,63,29,0,2,2,3,1,3,4,3,17,1119,0,15,1134,0
7,18,723,46,23,3,0,2,0,2,1,5,5,3,831,0,9,840,0
8,16,579,26,13,2,1,0,1,2,2,1,3,7,653,0,6,659,0
9,7,520,46,62,0,0,1,1,0,2,3,1,9,652,0,4,656,0
10,24,697,82,43,1,2,0,0,0,0,3,2,8,862,0,8,870,0
11,25,817,33,38,2,1,2,1,0,0,1,0,12,932,0,9,941,0
12,17,880,53,34,1,1,1,2,1,1,5,1,7,1004,0,6,1010,0
13,8,784,12,8,0,0,0,0,0,0,0,0,0,812,0,0,812,0
14,1,592,8,3,0,0,0,0,0,0,0,0,0,604,0,5,609,0
15,31,915,54,33,2,0,0,1,1,1,5,1,5,1049,0,13,1062,0
16,5,340,10,14,2,1,0,1,0,0,0,1,3,377,0,5,382,0
17,9,872,34,15,3,1,0,0,1,0,1,2,3,941,0,5,946,0
18,17,769,59,30,0,1,2,0,3,0,2,5,3,891,0,4,895,0
19,9,699,27,16,0,1,0,2,0,1,1,1,5,762,0,4,766,0
20,15,882,38,20,0,1,2,0,0,1,0,2,6,967,0,3,970,0
21,27,799,58,21,2,1,1,1,0,0,3,3,11,927,0,8,935,0
22,35,836,55,35,2,2,1,1,1,1,0,0,7,976,0,7,983,0
23,31,755,48,16,0,0,0,0,0,0,1,1,5,857,0,6,863,0
24,11,1003,33,17,0,0,0,0,0,1,0,2,1,1068,0,0,1068,0
25,8,606,34,5,0,1,0,0,1,0,0,2,6,663,0,4,667,0
26,22,446,27,9,0,0,0,0,0,0,0,1,3,508,0,2,510,0
27,121,804,62,16,1,0,0,0,1,1,1,3,6,1016,0,5,1021,0
28,0,0,0,0,0,0,0,0,0,0,0,0,0,0,0,0,0,0
29,29,904,51,21,0,0,1,0,0,1,0,4,9,1020,0,8,1028,0
30,16,702,18,18,0,0,0,0,0,0,1,2,9,766,0,4,770,0
31,10,730,39,15,0,0,0,1,0,0,1,4,2,802,0,3,805,0
32,31,712,28,11,0,1,0,0,0,0,0,1,1,785,0,2,787,0
33,21,740,23,15,2,0,0,0,1,0,2,2,2,808,0,1,809,0
34,37,939,38,29,2,0,1,0,0,3,0,0,1,1050,0,3,1053,0
35,19,779,40,41,3,0,1,0,1,0,0,2,6,892,0,5,897,0
36,478,197,17,39,0,0,1,1,0,2,0,0,3,738,0,5,743,0
37,365,347,8,65,2,2,1,1,1,0,4,2,3,801,0,8,809,0
38,315,469,21,48,1,0,0,0,0,1,1,0,2,858,0,3,861,0
39,164,336,8,51,1,2,0,0,0,1,0,1,4,568,0,2,570,0
40,149,214,20,144,2,0,2,0,0,0,0,0,2,533,0,10,543,0
41,22,953,48,33,1,0,1,0,1,3,2,0,6,1070,0,20,1090,0
42,9,706,22,13,0,0,0,1,0,0,0,0,2,753,0,5,758,0
43,12,677,18,16,3,0,1,0,1,1,1,3,9,742,0,0,742,0
44,26,931,53,21,1,1,1,1,1,0,0,1,3,1040,0,4,1044,0
45,26,673,31,23,0,1,0,0,0,0,2,2,9,767,0,4,771,0
46,29,1050,38,36,0,0,0,0,0,0,1,1,6,1161,0,5,1166,0
47,10,1011,33,8,2,1,0,0,0,0,0,5,1,1071,0,4,1075,0
48,91,367,14,12,6,1,2,0,0,1,1,0,3,498,0,2,500,0
49,322,328,16,33,0,1,0,0,0,1,0,2,3,706,0,3,709,0
50,24,604,36,36,0,0,0,0,0,1,0,2,4,707,0,2,709,0
51,16,588,20,25,1,1,1,0,1,1,1,2,4,661,0,2,663,0
52,30,917,36,14,0,0,0,0,0,0,0,0,3,1000,0,4,1004,0
53,350,392,11,99,6,0,0,1,1,0,0,0,6,866,0,7,873,0
54,162,211,4,48,0,0,1,0,0,1,0,0,1,428,0,4,432,0
55,19,511,30,19,0,0,0,0,0,0,0,2,2,583,0,5,588,0
56,216,615,32,102,0,1,0,1,0,0,0,1,4,972,0,13,985,0
57,274,316,15,78,1,0,2,1,0,1,1,1,6,696,0,4,700,0
58,309,322,10,67,3,0,2,3,0,0,1,1,3,721,0,13,734,0
59,23,794,55,40,1,2,0,0,1,0,0,4,8,928,0,5,933,0
60,24,602,50,33,0,0,1,1,0,0,0,1,1,713,0,1,714,0
61,173,663,33,35,1,1,0,0,1,1,1,2,6,917,0,6,923,0
62,172,514,34,24,2,1,1,2,0,2,1,2,5,760,0,7,767,0
63,109,213,11,104,0,0,0,0,0,0,0,0,0,437,0,5,442,0
64,420,428,23,156,3,2,2,0,0,0,2,1,0,1037,0,11,1048,0
65,123,855,68,80,2,1,0,0,0,1,1,1,7,1139,0,17,1156,0
66,11,841,18,11,0,0,0,0,0,0,0,3,5,889,0,3,892,0
67,20,686,77,28,0,0,3,0,0,2,2,2,4,824,0,5,829,0
68,212,241,3,46,3,0,0,0,1,1,0,2,1,510,0,1,511,0
69,255,352,7,93,1,1,2,0,0,2,1,1,0,715,0,10,725,0
70,493,371,12,125,4,0,1,3,0,2,1,3,2,1017,0,7,1024,0
71,311,456,26,116,2,0,1,0,0,1,2,1,0,916,0,11,927,0
72,210,572,35,128,5,2,3,1,0,0,2,4,6,968,0,9,977,0
73,307,478,28,52,0,3,0,2,0,0,0,1,4,875,0,6,881,0
74,100,141,2,18,0,0,0,0,0,0,0,1,1,263,0,6,269,0
75,394,330,24,145,3,2,5,1,1,0,0,1,2,908,0,11,919,0
76,288,435,11,186,3,0,3,1,0,0,1,1,1,930,0,8,938,0
77,247,391,15,222,0,2,2,0,0,1,2,1,1,884,0,5,889,0
78,268,473,12,51,2,0,1,0,0,0,2,2,3,814,0,6,820,0
79,268,354,17,49,0,0,1,0,0,0,1,0,1,691,0,8,699,0
80,149,175,10,92,0,0,0,1,0,0,0,0,1,428,0,2,430,0
81,457,203,17,41,0,1,5,0,1,2,0,2,1,730,0,9,739,0
82,373,128,9,46,1,3,0,2,0,1,0,3,0,566,0,4,570,0
83,365,208,25,60,0,0,1,0,1,0,4,2,4,670,0,11,681,0
84,247,373,30,97,1,0,1,0,1,1,0,2,2,755,0,8,763,0
85,225,160,16,87,1,1,1,0,1,0,0,0,1,493,0,8,501,0
86,436,287,16,131,2,0,0,0,2,0,1,0,3,878,0,7,885,0
87,336,314,12,144,1,1,0,2,1,0,0,2,1,814,0,8,822,0
88,280,302,19,190,0,1,1,1,0,0,0,0,2,796,0,6,802,0
89,312,78,6,48,0,0,1,0,2,1,0,0,3,451,0,8,459,0
90,449,140,27,59,0,0,3,0,0,1,0,1,0,680,0,7,687,0
91,408,122,7,53,2,0,3,2,0,0,2,0,2,601,0,3,604,0
92,342,238,7,71,0,1,4,2,1,1,2,3,3,675,0,3,678,0
93,436,153,5,28,1,1,0,0,1,3,0,0,0,628,0,2,630,0
94,459,151,7,60,2,0,2,0,2,2,4,1,8,698,0,5,703,0
95,422,247,21,87,1,2,1,2,1,2,0,4,2,792,0,6,798,0
96,407,223,20,69,0,0,1,3,1,0,0,1,1,726,0,18,744,0
97,493,218,17,97,1,2,2,2,0,1,2,0,1,836,0,3,839,0
98,203,301,11,75,1,2,0,0,0,0,0,0,1,594,0,8,602,0
99,147,185,8,73,1,0,2,1,0,0,1,1,3,422,0,4,426,0
100,275,303,32,74,2,3,0,1,0,1,2,0,1,694,0,7,701,0
101,394,259,26,148,2,1,3,1,0,1,0,0,1,836,0,9,845,0
102,254,260,21,123,0,1,0,0,0,1,2,0,1,663,0,14,677,0
103,315,214,11,174,1,1,3,1,0,2,1,3,0,726,0,6,732,0
104,324,264,27,136,0,1,0,0,0,1,2,2,1,758,0,9,767,0
105,313,301,14,169,0,1,4,0,0,2,0,0,0,804,0,5,809,0
106,489,164,13,79,2,1,0,0,1,0,1,1,3,754,0,2,756,0
107,397,299,11,39,3,0,1,1,1,1,1,1,4,759,0,9,768,0
108,430,257,13,118,1,1,1,0,0,1,1,2,0,825,0,3,828,0
109,293,332,12,131,2,1,9,1,0,1,2,2,6,792,0,10,802,0
110,276,211,13,141,0,0,1,2,0,0,2,3,1,650,0,16,666,0
111,357,311,24,141,0,0,0,1,0,1,3,2,4,844,0,11,855,0
112,251,323,20,56,1,1,0,0,0,0,0,0,1,653,0,10,663,0
113,162,280,12,96,0,0,1,2,0,1,1,2,3,560,0,11,571,0
114,314,398,19,78,3,1,2,0,0,2,2,3,2,824,0,16,840,0
115,233,261,13,91,1,3,1,1,0,3,0,0,3,610,0,8,618,0
116,186,254,22,182,1,1,3,0,0,0,0,4,1,654,0,4,658,0
117,135,267,26,116,0,1,1,0,0,0,0,0,0,546,0,12,558,0
118,178,313,23,114,0,3,1,0,0,0,1,0,1,634,0,11,645,0
119,400,274,12,100,0,1,2,1,1,3,1,4,5,804,0,4,808,0
120,297,429,25,154,3,0,0,0,0,1,1,0,1,911,0,12,923,0
121,235,426,15,101,2,2,2,0,1,1,0,6,5,796,0,9,805,0
122,340,327,16,217,5,0,0,2,0,1,3,1,0,912,0,8,920,0
123,249,235,28,203,1,1,1,1,1,0,0,0,3,723,0,6,729,0
124,302,261,24,192,3,2,2,0,0,1,0,3,3,793,0,10,803,0
125,265,299,26,115,1,1,0,0,0,0,0,0,1,708,0,8,716,0
126,341,233,31,168,2,0,0,1,0,0,2,1,0,779,0,15,794,0
127,251,304,30,146,1,0,2,3,0,2,1,3,1,744,0,15,759,0
128,141,157,18,85,1,0,0,1,0,0,1,0,2,406,0,6,412,0
129,297,245,16,99,4,1,0,0,0,0,1,1,2,666,0,7,673,0
130,284,216,17,90,0,0,1,0,0,0,0,1,1,610,0,9,619,0
131,204,257,20,145,0,2,0,0,0,1,0,4,0,633,0,9,642,0
132,337,216,19,151,0,2,2,0,1,0,0,1,5,734,0,8,742,0
133,198,320,28,193,2,1,1,1,0,2,1,0,0,747,0,23,770,0
134,285,271,14,156,2,3,4,1,2,2,1,2,3,746,0,7,753,0
135,275,268,6,192,2,1,2,2,1,1,1,2,2,755,0,7,762,0
136,147,206,9,149,3,1,0,0,0,1,2,1,0,519,0,7,526,0
137,237,313,14,261,4,2,1,0,1,1,0,1,3,838,0,7,845,0
138,235,192,12,379,4,2,8,2,0,3,9,6,4,856,0,7,863,0
139,173,156,14,266,0,0,1,0,0,0,3,2,3,618,0,5,623,0
140,231,189,9,383,1,1,8,0,1,0,1,0,4,828,0,8,836,0
141,160,339,19,136,1,3,0,0,0,1,0,1,4,664,0,12,676,0
142,201,309,11,194,3,1,1,1,0,0,2,2,1,726,0,8,734,0
143,112,157,26,111,1,0,1,0,0,0,0,0,0,408,0,11,419,0
144,111,232,9,127,1,2,1,0,0,1,0,1,0,485,0,8,493,0
145,149,216,13,160,1,0,1,0,0,0,0,0,3,543,0,10,553,0
146,127,182,13,123,0,0,0,1,0,0,1,0,0,447,0,8,455,0
147,254,290,13,192,0,1,2,1,2,1,1,0,3,760,0,12,772,0
148,178,283,22,274,1,1,1,0,1,1,2,3,6,773,0,13,786,0
149,206,304,18,127,2,0,0,0,0,1,0,1,1,660,0,16,676,0
150,248,245,17,119,2,1,0,0,0,1,0,1,0,634,0,11,645,0
151,93,116,6,74,0,3,0,0,0,0,0,0,1,293,0,7,300,0
152,127,190,11,81,0,2,0,0,0,1,1,1,0,414,0,10,424,0
153,208,272,16,154,2,0,0,1,1,0,0,2,1,657,0,6,663,0
154,127,289,21,137,1,2,4,0,1,2,0,1,2,587,0,2,589,0
155,209,206,20,183,0,1,0,0,0,0,2,1,1,623,0,11,634,0
156,240,227,14,107,4,2,3,0,0,1,3,2,0,603,0,5,608,0
157,206,294,24,116,3,1,1,0,0,1,2,3,0,651,0,8,659,0
158,136,277,14,80,1,0,2,2,1,1,3,0,0,517,0,7,524,0
159,145,188,25,80,0,0,2,0,0,0,0,1,0,441,0,15,456,0
160,102,146,13,64,0,3,1,0,0,1,0,1,0,331,0,2,333,0
161,203,432,20,124,2,2,3,1,1,0,3,1,3,795,0,4,799,0
162,185,292,11,132,0,0,1,0,0,0,2,2,1,626,0,6,632,0
163,171,300,8,85,0,1,0,0,0,1,3,1,4,574,0,9,583,0
164,206,223,24,180,1,1,1,0,0,0,0,1,1,638,0,18,656,0
165,116,158,16,105,0,2,0,0,0,1,1,1,1,401,0,9,410,0
166,195,183,15,208,2,1,4,0,1,0,3,1,0,613,0,12,625,0
167,180,234,9,224,1,2,2,1,1,1,3,4,2,664,0,11,675,0
168,280,296,19,263,2,1,2,0,1,2,2,3,4,875,0,8,883,0
169,98,143,14,107,0,0,1,0,1,0,0,0,1,365,0,11,376,0
170,252,250,6,185,3,3,3,0,0,3,6,4,5,720,0,6,726,0
171,138,158,7,90,0,2,1,0,0,0,1,0,1,398,0,7,405,0
172,136,222,18,178,1,1,0,1,1,0,1,0,2,561,0,15,576,0
173,152,198,17,170,1,6,1,0,0,1,0,1,0,547,0,13,560,0
174,158,221,13,191,2,0,0,0,0,1,0,2,0,588,0,16,604,0
175,159,175,23,118,1,2,0,1,1,0,1,0,1,482,0,9,491,0
176,165,220,20,152,0,1,0,1,0,1,4,2,2,568,0,10,578,0
177,129,213,17,147,2,4,0,0,0,0,0,0,0,512,0,14,526,0
178,87,170,8,120,0,6,0,0,0,1,0,0,0,392,0,11,403,0
179,90,200,23,141,0,8,2,0,0,0,1,0,0,465,0,18,483,0
180,118,165,11,119,1,4,0,0,0,0,0,0,0,418,0,10,428,0
181,74,156,11,163,0,0,0,0,0,1,1,1,0,407,0,9,416,0
182,113,184,5,185,1,9,1,0,0,1,2,2,0,503,0,8,511,0
183,165,279,20,259,0,0,0,0,0,0,3,1,0,727,0,13,740,0
184,120,217,18,138,1,2,0,0,0,0,0,0,1,497,0,18,515,0
185,127,208,18,191,3,12,1,1,0,0,3,1,0,565,0,16,581,0
186,131,200,12,138,0,1,0,0,0,1,0,1,0,484,0,9,493,0
187,222,174,17,84,0,0,0,0,0,0,0,0,0,497,0,15,512,0
188,188,195,13,134,1,2,0,0,0,0,0,0,0,533,0,14,547,0
189,177,236,18,193,1,2,0,0,1,0,2,0,0,630,0,19,649,0
190,207,180,9,156,0,3,1,0,0,0,0,0,0,556,0,10,566,0
191,183,208,16,185,0,0,1,0,0,0,2,1,2,598,0,5,603,0
192,179,273,15,164,0,3,1,3,2,0,3,3,2,648,0,5,653,0
193,138,161,22,169,0,0,0,0,1,0,1,1,3,496,0,4,500,0
194,134,191,17,184,2,2,0,0,0,0,2,0,0,532,0,6,538,0
195,189,262,37,149,0,4,0,0,0,0,0,0,2,643,0,11,654,0
196,172,221,26,229,1,0,1,0,0,1,2,1,0,654,0,14,668,0
197,143,195,18,169,2,0,3,0,0,0,0,0,2,532,0,8,540,0
198,126,160,8,156,0,0,0,0,1,0,0,0,0,451,0,8,459,0
199,142,126,8,132,0,2,0,0,0,0,0,1,3,414,0,4,418,0
200,238,219,14,154,1,1,1,0,1,1,1,2,1,634,0,17,651,1
201,152,213,12,210,0,1,0,0,0,0,1,0,0,589,0,9,598,0
202,239,226,19,195,0,0,3,1,0,1,0,0,1,685,0,15,700,0
203,236,245,18,145,0,0,1,1,0,0,0,1,0,647,0,20,667,0
204,143,179,14,138,1,1,0,1,0,0,0,0,2,479,0,6,485,0
205,170,247,22,201,1,2,2,0,0,0,0,0,1,646,0,15,661,0
206,179,249,18,167,0,1,0,0,0,0,0,1,1,616,0,17,633,0
207,131,171,11,91,0,1,0,0,0,0,0,0,0,405,0,7,412,0
208,195,215,15,139,1,1,1,1,0,1,1,1,1,572,0,7,579,0
209,122,198,7,83,0,2,2,0,0,0,0,1,1,416,0,6,422,0
210,176,396,5,142,1,1,4,1,0,2,0,3,2,733,0,11,744,0
211,196,380,17,110,2,1,1,0,0,1,1,1,6,716,0,11,727,0
212,179,183,16,94,1,1,0,0,1,1,0,1,1,478,0,12,490,0
213,203,241,17,103,1,0,0,0,0,0,0,0,0,565,0,6,571,0
214,169,284,8,79,0,3,2,0,1,0,0,1,2,549,0,6,555,0
215,74,138,4,66,1,3,0,0,0,0,0,0,0,286,0,7,293,0
216,193,229,26,177,0,1,0,0,0,0,0,0,0,626,0,11,637,0
217,332,313,15,174,4,0,2,0,0,1,1,2,4,848,0,5,853,0
218,345,375,12,156,2,4,2,2,0,0,2,2,1,903,0,10,913,0
219,215,171,24,124,3,0,0,1,0,0,0,0,1,539,0,10,549,0
220,288,183,18,120,0,0,0,0,0,1,0,0,1,611,0,15,626,0
221,384,399,20,118,4,0,1,1,0,1,1,2,4,935,0,13,948,0
222,258,274,16,125,2,1,1,1,1,0,3,3,2,687,0,9,696,0
223,307,355,22,210,0,0,2,1,0,1,0,2,3,903,0,7,910,0
224,170,212,16,55,0,1,0,1,1,1,0,0,1,458,0,5,463,0
225,194,191,11,100,1,0,0,0,0,0,0,0,0,497,0,7,504,0
226,265,187,23,117,0,1,0,3,0,0,0,1,0,597,0,15,612,0
227,305,334,23,112,2,2,0,0,1,0,0,2,3,784,0,11,795,0
228,400,285,29,172,0,1,0,0,0,0,1,0,2,890,0,13,903,0
229,309,284,12,105,3,1,0,1,1,1,2,0,0,719,0,8,727,0
230,300,243,9,119,0,0,0,0,1,1,1,2,4,680,0,13,693,0
231,264,239,19,124,1,2,1,2,1,1,1,0,4,659,0,8,667,0
232,321,278,15,123,0,0,3,1,0,2,1,4,1,749,0,13,762,0
233,463,299,38,93,2,0,2,0,1,1,1,3,1,904,0,11,915,0
234,523,295,16,74,4,1,3,1,1,0,2,1,2,923,0,8,931,0
235,458,246,29,87,3,2,3,0,1,1,2,3,2,837,0,12,849,0
236,506,364,22,83,2,0,1,0,0,1,2,2,1,984,0,11,995,0
237,357,170,17,50,2,0,3,1,1,1,1,0,1,604,0,7,611,0
238,309,223,8,38,0,0,0,1,0,0,1,1,0,581,0,6,587,0
239,322,276,22,96,0,1,1,0,1,1,2,1,2,725,0,0,725,0
240,229,93,8,24,0,0,0,0,1,0,1,2,3,361,0,1,362,0
241,325,184,16,71,2,0,1,0,0,1,1,1,1,603,0,10,613,0
242,563,375,11,179,1,0,1,0,0,2,2,4,5,1143,0,9,1152,0
243,501,363,10,101,2,1,0,0,0,0,0,4,1,983,0,1,984,0
244,291,144,10,63,2,1,3,0,1,0,2,1,0,518,0,5,523,0
245,357,170,7,68,1,0,1,0,1,0,0,1,2,608,0,6,614,0
246,401,229,10,38,1,1,1,2,0,1,1,0,2,687,0,5,692,0
247,273,103,2,18,1,0,0,0,0,1,0,0,0,398,0,2,400,0
248,614,278,13,31,2,1,0,2,1,1,2,0,6,951,0,18,969,0
249,308,454,45,27,3,0,3,0,5,3,0,4,11,863,0,6,869,0
250,436,283,15,28,5,1,3,0,1,1,1,3,6,783,0,9,792,0
251,301,154,12,47,1,0,1,3,0,1,1,3,3,527,0,8,535,0
252,513,336,22,103,1,2,3,0,0,3,1,1,1,986,0,15,1001,0
253,489,296,19,119,4,0,1,0,1,3,0,3,3,938,0,8,946,0
254,442,269,15,93,2,0,4,0,2,0,0,1,3,831,0,4,835,0
255,195,153,7,69,0,0,2,0,0,1,0,0,2,429,0,3,432,0
256,469,332,21,172,5,1,2,2,0,0,1,1,4,1010,0,6,1016,0
257,382,199,5,68,4,1,2,1,0,2,2,3,3,672,0,2,674,0
258,352,240,9,51,0,0,4,0,3,3,2,4,5,673,0,12,685,0
259,358,221,1,56,3,1,4,0,0,5,2,4,0,655,0,8,663,0
260,333,273,11,65,0,0,3,1,2,2,1,3,1,695,0,5,700,0
261,449,291,7,56,4,1,2,0,1,2,1,1,2,817,0,5,822,0
262,341,321,8,45,4,1,3,1,0,5,1,2,6,738,0,13,751,0
263,376,195,13,41,2,0,2,0,2,1,3,2,4,641,0,5,646,0
264,478,388,14,61,3,4,4,2,1,4,1,3,5,968,0,16,984,0
265,218,192,27,142,1,4,1,4,0,0,0,0,0,589,0,9,598,0
266,418,184,25,170,0,1,0,0,0,0,0,0,1,799,0,18,817,0
267,183,127,9,88,0,1,1,2,0,0,1,1,0,413,0,11,424,0
268,372,422,22,201,1,0,2,0,1,4,7,4,6,1042,0,7,1049,0
269,368,477,14,219,2,0,5,1,3,6,5,6,7,1113,0,19,1132,0
270,287,166,14,142,1,1,0,1,1,0,2,1,4,620,0,8,628,0
271,347,170,14,139,1,2,1,0,1,0,1,2,0,678,0,18,696,0
272,230,153,9,132,0,2,1,0,0,0,0,1,0,528,0,3,531,0
273,496,368,27,54,2,2,2,1,2,1,5,7,12,979,0,7,986,0
274,480,352,13,31,4,0,1,0,0,2,3,2,5,893,0,9,902,0
275,347,231,9,124,0,1,4,2,2,2,3,5,2,732,0,8,740,0
276,412,243,12,115,2,1,6,3,1,8,13,5,5,826,0,11,837,0
277,431,272,9,111,5,2,10,2,0,2,4,2,5,855,0,14,869,0
278,462,361,17,135,2,1,9,2,2,7,4,6,10,1018,0,9,1027,0
279,264,593,8,237,7,3,3,0,4,3,3,7,19,1151,0,21,1172,0
280,218,387,14,143,3,1,1,1,1,0,0,1,2,772,0,11,783,0
281,153,326,14,116,2,1,2,0,2,0,2,3,3,624,0,7,631,0
282,230,224,9,133,0,1,1,1,0,1,0,0,2,602,0,4,606,0
283,298,293,13,111,0,4,2,0,0,2,1,3,14,741,0,12,753,0
284,192,137,8,103,2,1,0,0,0,0,1,0,0,444,0,4,448,0
285,243,161,15,160,0,1,2,0,0,0,0,3,5,590,0,11,601,0
28,21,769,42,14,1,0,0,0,0,0,1,2,3,853,0,3,856,0
1,156,211,20,57,0,1,1,0,0,0,0,1,0,447,0,2,449,0
2,197,205,6,40,1,0,1,1,0,0,0,1,3,455,0,5,460,0
3,363,193,11,48,3,0,0,0,0,0,0,2,5,625,0,8,633,0
4,238,255,21,40,1,0,0,0,0,0,0,2,2,559,0,5,564,0
5,350,136,7,60,0,0,0,0,0,0,2,0,0,555,0,4,559,0
6,301,444,17,124,6,1,0,2,2,0,3,5,13,918,0,10,928,0
7,354,191,27,70,0,0,1,0,0,2,0,5,4,654,0,8,662,0
8,305,377,19,74,1,0,3,0,1,3,0,4,4,791,0,7,798,0
9,330,341,11,34,2,4,0,1,0,2,1,3,6,735,0,5,740,0
10,402,175,16,27,0,1,1,0,0,2,0,0,1,625,0,11,636,0
11,353,171,18,55,0,0,0,0,0,0,0,0,2,599,0,5,604,0
12,356,232,22,19,6,1,1,0,1,0,1,2,2,643,0,8,651,0
13,335,136,8,24,1,0,0,0,1,0,0,0,0,505,0,1,506,0
14,288,205,13,49,3,0,2,0,0,1,1,1,0,563,0,2,565,0
15,282,297,17,21,0,2,1,0,0,0,1,1,1,623,0,7,630,0
16,312,288,6,22,0,2,0,0,1,0,0,2,2,635,0,7,642,0
17,338,312,17,33,0,2,2,0,0,1,0,2,9,716,0,9,     ''?''725,0
18,358,366,15,51,6,0,1,0,0,0,2,4,5,808,0,9,817,0
19,258,250,14,115,0,0,0,1,0,0,0,0,1,639,0,19,658,0
20,352,250,17,126,0,1,0,0,0,1,0,0,1,748,0,17,765,0
21,327,351,18,97,2,1,0,0,0,1,1,3,4,805,0,11,816,0
22,427,254,23,108,3,2,0,0,1,1,2,4,1,826,0,7,833,0
23,424,165,13,40,0,0,0,0,0,0,1,0,3,646,0,6,652,0
24,315,232,14,61,2,3,1,1,0,1,1,4,3,638,0,7,645,0
25,         3?-l,324,21,38,0,1,2,1,1,0,3,3,4,719,0,5,724,0
26,263,225,7,34,0,3,0,0,0,2,3,1,2,540,0,5,545,0
27,455,346,24,78,1,0,2,1,0,0,1,1,3,912,0,10,922,0
28,408,508,17,63,2,2,0,2,1,0,2,1,10,1016,0,15,1031,0
29,298,237,6,52,0,1,2,0,0,2,1,2,6,607,0,9,616,0
30,309,290,14,37,2,0,1,0,1,0,3,4,6,667,0,8,675,0
31,413,203,18,49,2,8,0,0,0,0,0,2,0,        695/?,0,9,704,0
32,436,268,26,94,0,6,2,1,2,0,0,1,2,838,0,9,847,0
33,458,386,23,76,2,3,3,0,2,4,1,3,10,971,0,7,978,0
34,326,325,8,74,1,3,2,1,0,3,0,2,3,748,0,2,750,0
35,187,295,13,101,1,4,1,0,1,0,2,2,5,612,0,2,614,0
36,239,195,18,95,1,1,0,0,0,0,1,3,0,553,0,8,561,0
37,98,96,7,84,1,0,2,0,0,0,0,0,0,288,0,7,295,0
38,205,221,12,56,3,2,1,0,0,0,0,1,1,502,0,7,509,0
39,301,367,21,106,3,5,3,0,2,3,3,0,6,820,0,11,831,0
40,275,187,10,53,1,1,1,1,0,1,2,2,4,538,0,8,546,0
41,285,243,11,52,3,0,0,1,0,0,0,0,5,600,0,6,606,0
42,304,338,17,70,1,1,2,0,2,1,1,3,2,742,0,6,748,0
43,324,298,13,73,0,1,1,0,1,1,2,1,5,720,0,6,726,0
44,271,324,25,159,4,3,1,0,1,0,0,1,2,791,0,10,801,0
45,194,154,9,50,0,1,0,2,0,0,0,0,0,410,0,2,412,0
46,136,393,10,110,1,3,1,0,1,0,1,4,0,660,0,4,664,0
47,81,193,14,54,1,1,0,0,0,0,1,2,0,347,0,4,351,0
48,284,344,33,171,1,3,1,0,0,2,2,3,2,846,0,10,856,0
49,223,347,32,137,1,2,1,1,0,2,2,0,1,749,0,12,761,0
50,371,339,15,183,3,1,6,1,1,1,4,3,4,932,0,20,952,0
51,91,77,9,51,0,1,1,0,0,0,1,0,0,231,0,1,232,0
52,172,156,7,22,1,0,2,0,0,0,0,0,0,360,0,4,364,0
53,140,203,13,66,1,2,1,1,0,1,0,1,1,430,0,4,434,0
54,219,247,25,106,0,0,0,0,0,0,0,1,0,598,0,9,607,0
55,183,224,20,86,0,1,1,0,0,0,0,0,0,515,0,8,523,0
56,251,348,24,144,2,4,6,0,0,0,0,0,0,779,0,13,792,0
57,179,355,20,87,1,0,0,0,0,1,0,1,2,646,0,6,652,0
58,181,200,13,98,1,0,0,0,0,0,0,1,0,494,0,5,499,0
59,242,286,22,156,5,2,3,1,1,1,2,1,3,725,0,10,735,0
60,227,278,11,97,2,1,0,0,0,0,1,0,4,621,0,3,624,0
61,129,154,12,47,0,1,1,0,0,0,0,0,0,344,0,2,346,0
62,225,321,14,136,0,2,2,0,0,0,3,1,0,704,0,12,716,0
63,219,265,16,119,3,0,4,0,2,0,2,1,2,633,0,10,643,0
64,304,274,7,129,2,1,1,0,2,3,3,2,5,733,0,6,739,0
65,203,223,12,228,1,4,3,2,2,1,0,1,0,680,0,9,689,0
66,203,169,3,135,0,1,2,0,0,1,0,1,1,516,0,8,524,0
67,177,175,9,95,0,2,1,0,0,0,0,0,0,459,0,14,473,0
68,156,331,30,127,1,0,0,1,1,0,1,0,2,650,0,7,657,0
69,151,316,24,126,1,2,0,0,0,1,0,1,0,622,0,13,635,0
70,262,321,16,104,1,1,0,0,0,1,1,3,1,711,0,9,720,0
71,185,212,17,113,0,0,2,0,0,1,0,0,1,     /531,0,7,538,0
72,135,132,14,67,0,1,0,0,0,0,0,0,0,349,0,8,357,0
73,274,233,14,125,4,1,2,1,1,0,4,1,2,662,0,10,672,0
74,201,167,20,96,0,1,1,0,0,0,2,2,2,492,0,10,502,0
75,367,269,20,187,3,0,1,3,1,1,0,2,2,856,0,7,863,0
76,331,273,23,122,3,2,8,2,2,2,3,3,4,778,0,7,785,0
77,268,306,24,205,1,1,4,0,0,2,1,2,1,815,0,10,825,0
78,316,263,17,155,3,2,2,0,0,0,1,0,1,760,0,18,778,0
79,244,380,24,103,1,6,2,1,1,0,2,1,2,767,0,10,777,0
80,175,207,17,103,1,5,0,2,0,0,1,1,1,513,0,14,527,0
81,259,232,12,100,5,0,4,1,0,1,3,1,2,620,0,5,625,0
82,238,306,30,105,2,3,1,0,1,1,2,2,0,691,0,8,699,0
83,214,321,29,77,2,5,3,1,0,0,0,0,1,653,0,10,663,0
84,279,307,25,118,2,6,1,0,0,1,0,0,8,747,0,8,755,0
85,272,216,14,62,0,5,0,0,0,1,0,0,0,570,0,8,578,0
86,147,154,5,76,0,0,1,0,0,0,0,0,1,384,0,1,385,0
87,190,219,12,112,0,8,1,0,0,0,0,2,0,544,0,7,551,0
88,160,141,5,95,1,5,1,0,0,0,0,1,0,409,0,8,417,0
89,212,272,24,105,4,8,4,2,0,2,0,1,0,634,0,13,647,0
90,194,186,17,90,1,0,3,1,0,0,0,0,1,493,0,6,499,0
91,281,307,22,62,1,2,4,1,0,1,1,4,3,689,0,15,704,0
92,235,241,14,116,0,3,3,1,0,1,1,2,1,618,0,9,627,0
93,170,115,21,39,0,1,0,0,1,0,0,2,4,353,0,13,366,0
94,241,237,20,90,1,6,1,2,0,1,2,0,1,602,0,8,610,0
95,168,217,25,157,1,3,0,0,0,0,4,0,1,576,0,9,585,0
96,231,328,19,137,1,9,0,0,2,0,2,1,0,730,0,8,738,0
97,188,229,18,113,3,15,2,0,1,0,1,3,2,575,0,7,582,0
98,179,207,8,60,4,5,3,0,1,1,3,1,3,475,0,7,482,0
99,286,318,17,104,1,3,2,0,1,0,0,1,3,736,0,5,741,0
100,137,130,9,59,0,5,1,0,1,1,0,1,2,346,0,8,354,0
101,205,323,14,169,3,0,3,1,1,1,1,3,2,726,0,12,738,0
102,288,330,14,110,2,1,2,1,0,1,0,1,4,754,0,17,771,0
103,191,360,21,154,1,2,0,0,0,0,1,2,2,734,0,6,740,0
104,136,263,12,147,4,0,2,0,0,1,0,3,2,570,0,7,577,0
105,297,396,20,126,0,3,1,0,0,0,1,1,2,847,0,10,857,0
106,181,282,32,127,0,0,2,0,0,0,2,1,2,629,0,10,639,0
107,183,385,28,194,0,1,2,1,0,0,2,0,0,796,0,11,807,0
108,163,127,3,86,0,0,0,0,1,1,0,0,0,381,0,7,388,0
109,381,314,20,120,1,3,2,0,1,0,2,0,3,847,0,3,850,0
110,213,281,20,227,0,1,1,0,1,0,1,2,2,749,0,13,762,0
111,108,276,12,98,1,2,0,0,0,1,1,0,        1   /,500,0,8,508,0
112,195,294,20,264,1,1,0,0,0,1,0,0,1,777,0,7,784,0
113,351,285,16,158,2,0,0,0,0,2,0,0,1,815,0,12,827,0
114,293,355,24,122,1,1,0,1,1,0,0,8,4,810,0,14,824,0
115,378,339,25,108,1,1,1,1,0,0,0,1,3,858,0,10,868,0
116,226,289,19,100,1,0,2,0,0,0,2,2,1,642,0,8,650,0
117,347,237,11,107,0,3,0,1,0,3,1,0,1,711,0,15,726,0
118,160,186,13,83,0,1,1,1,1,0,0,1,1,448,0,9,457,0
119,142,202,15,137,0,3,0,1,0,0,0,1,0,501,0,9,510,0
120,149,269,16,128,1,0,1,0,1,0,0,0,1,566,0,10,576,0
121,223,298,16,159,0,3,2,0,0,0,1,0,1,703,0,13,716,0
122,200,275,19,135,0,1,3,0,0,1,0,1,2,637,0,11,        64S,0
123,156,187,10,126,1,1,1,0,0,0,1,0,0,483,0,6,489,0
124,155,203,13,118,0,1,0,0,0,0,1,0,0,491,0,10,501,0
125,160,252,22,143,2,0,2,0,0,0,1,0,2,584,0,8,592,0
126,163,267,20,131,0,0,1,0,0,0,1,1,0,584,0,6,590,0
127,182,223,17,111,0,2,0,1,1,1,1,0,0,539,0,12,551,0
128,169,257,16,109,1,4,1,0,0,1,1,1,1,561,0,14,575,0
129,124,127,12,279,0,0,0,0,0,1,1,2,0,546,0,11,557,0
130,142,311,12,132,2,1,0,0,2,0,1,0,2,605,0,6,611,0
131,205,346,15,150,0,0,0,1,0,1,1,2,1,722,0,9,731,0
132,290,389,29,172,1,2,1,0,1,0,4,2,3,894,0,12,906,0
133,160,271,22,62,1,4,0,0,0,0,0,0,1,521,0,9,530,0
134,311,285,25,90,2,1,0,0,0,1,1,0,1,717,0,3,720,0
135,255,256,11,107,2,2,1,0,0,0,0,1,1,636,0,13,649,0
136,200,251,16,97,2,2,1,0,0,1,0,0,0,570,0,8,578,0
137,253,222,19,155,1,1,0,0,0,0,0,1,0,652,0,14,666,0
138,254,244,12,224,1,1,0,2,2,1,1,0,2,744,0,5,749,0
139,191,370,18,121,1,1,0,1,0,1,1,1,2,708,0,13,721,0
140,210,357,26,219,2,3,2,2,1,1,0,1,0,824,0,11,835,0
141,270,264,11,173,0,2,0,0,0,0,2,1,2,725,0,8,733,0
142,285,401,27,210,0,0,3,0,0,0,1,0,2,929,0,18,947,0
143,200,371,16,183,1,0,2,0,0,1,1,1,4,780,0,13,793,0
144,187,302,15,198,3,3,5,1,0,0,3,1,0,718,0,4,722,0
145,140,326,11,155,1,0,1,0,2,1,3,3,6,649,0,7,656,0
146,220,597,19,126,8,0,2,1,1,1,3,3,5,986,0,1,987,0
147,212,206,15,116,0,1,0,0,0,0,0,0,1,551,0,4,555,0
148,190,219,15,114,0,1,0,0,1,0,1,2,0,543,0,8,551,0
149,302,351,18,204,3,1,1,1,0,3,0,2,7,893,0,7,900,0
150,100,98,1,60,0,0,0,0,0,0,0,0,1,260,0,0,260,0
151,292,458,15,198,3,1,2,0,0,0,0,2,         3/,974,0,12,986,0
152,156,298,11,84,0,0,1,0,0,0,1,1,3,555,0,2,557,0
153,261,269,10,118,1,2,1,0,1,2,1,2,0,668,0,5,673,0
154,242,374,17,144,1,2,0,3,1,1,2,1,1,789,0,8,797,0
155,200,208,5,107,1,0,2,0,2,2,0,1,2,530,0,8,538,0
156,218,355,17,209,1,4,3,0,3,2,2,1,5,820,0,10,830,0
157,256,399,20,153,6,2,0,0,1,1,0,4,2,844,0,5,849,0
158,261,319,8,136,1,0,5,1,0,4,0,2,2,739,0,3,742,0
159,242,302,10,100,0,2,2,0,0,0,1,0,3,662,0,4,666,0
160,151,177,6,86,0,2,1,0,0,0,0,0,1,424,0,2,426,0
161,201,342,18,121,0,1,0,0,0,2,2,0,3,690,0,3,693,0
162,278,295,23,97,0,0,1,0,0,0,0,1,4,699,0,7,706,0
163,150,455,16,173,3,1,2,0,0,1,2,3,3,809,0,5,814,0
164,263,406,18,138,1,0,3,1,0,0,2,3,3,838,0,6,844,0
165,268,356,13,142,2,2,2,0,0,3,4,0,0,792,0,7,799,0
166,190,368,14,104,2,3,2,1,0,3,1,0,3,691,0,6,697,0
167,206,367,27,114,1,1,3,1,0,0,0,0,1,721,0,3,724,0
168,140,376,19,88,2,0,1,1,1,1,1,0,3,633,0,8,641,0
169,348,374,15,156,3,2,7,1,1,2,2,1,3,915,0,21,936,0
170,355,289,17,166,2,2,4,0,0,1,1,1,0,838,0,15,853,0
171,170,179,7,95,1,2,1,0,0,0,1,0,0,456,0,7,463,0
172,190,274,20,144,3,4,2,0,0,0,0,1,4,642,0,7,649,0
173,179,193,10,85,2,0,3,2,0,0,0,2,2,478,0,4,482,0
174,229,269,23,119,2,3,0,0,0,0,1,0,5,651,0,11,662,0
175,227,228,16,111,1,0,1,0,1,0,0,2,2,589,0,6,595,0
176,228,303,37,195,4,3,1,2,1,0,0,0,0,774,0,9,783,0
177,188,171,19,107,1,0,0,0,0,0,0,0,0,486,0,9,495,0
178,290,214,31,91,2,0,4,0,0,0,1,0,0,633,0,16,649,0
179,213,252,17,119,0,1,0,1,1,0,3,0,2,609,0,17,626,0
180,223,209,12,108,0,2,0,1,2,0,1,0,1,559,0,7,566,0
181,162,207,13,101,0,0,1,0,0,0,0,2,0,486,0,9,495,0
182,237,259,16,166,1,4,0,1,0,0,1,0,0,685,0,15,700,0
183,207,214,12,127,0,3,2,1,0,1,0,0,0,567,0,13,580,0
184,180,188,10,119,2,3,1,0,0,0,0,0,1,504,0,12,516,0
185,298,277,18,158,1,0,2,1,0,0,0,1,0,756,0,11,767,0
186,194,209,11,60,1,0,1,0,0,1,1,0,2,480,0,7,487,0
187,266,290,23,149,0,0,0,0,0,0,0,1,0,729,0,17,746,0
188,337,288,27,182,2,2,2,0,0,1,0,3,0,844,0,14,858,0
189,286,289,27,136,2,2,2,0,1,1,1,0,1,748,0,14,762,0
190,282,347,29,165,3,0,4,0,1,0,2,0,0,833,0,14,847,0
191,319,354,9,134,2,1,2,0,0,1,2,2,         3?,829,0,11,840,0
192,134,188,9,105,1,1,0,1,0,0,0,0,0,439,0,3,442,0
193,287,242,12,118,0,4,0,0,0,0,2,3,1,669,0,16,685,0
194,214,240,27,102,0,0,3,3,1,0,1,3,2,596,0,14,610,0
195,283,245,25,147,1,2,1,1,0,1,2,0,0,708,0,12,720,0
196,251,266,15,169,1,2,1,0,0,0,2,0,0,707,0,11,718,0
197,231,287,15,119,1,6,0,0,0,0,0,1,0,660,0,12,672,0
198,153,195,12,115,0,1,0,0,0,0,0,0,0,476,0,11,487,0
199,210,300,21,171,2,2,0,0,0,0,0,0,1,707,0,10,717,0
200,204,226,9,144,1,1,0,0,0,0,0,0,2,587,0,6,593,0
201,210,201,16,104,0,5,0,0,1,0,0,0,0,537,0,10,547,0
202,215,244,16,120,2,3,0,1,0,1,1,1,4,608,0,8,616,0
203,202,232,14,120,0,9,0,0,0,2,0,0,1,580,0,7,587,0
204,271,220,16,102,5,2,1,2,0,3,2,1,3,628,0,3,631,0
205,332,293,15,91,2,2,0,0,0,1,2,1,1,740,0,13,753,0
206,134,91,8,61,0,0,0,0,0,0,0,0,0,294,0,11,305,0
207,358,305,16,176,3,4,0,1,1,2,2,3,2,873,0,8,881,0
208,232,180,8,99,3,0,3,1,0,1,1,0,2,530,0,6,536,0
209,379,469,27,156,4,0,1,0,1,1,4,7,7,1056,0,18,1074,0
210,341,371,20,127,2,0,2,1,0,2,2,5,4,877,0,4,881,0
211,209,236,16,88,8,2,1,1,0,1,1,1,0,564,0,10,574,0
212,154,183,3,62,0,0,0,2,0,0,0,1,0,405,0,6,411,0
213,222,317,16,172,1,5,0,0,0,0,0,2,1,736,0,6,742,0
214,402,320,19,144,1,3,1,1,1,0,0,2,2,896,0,8,904,0
215,392,317,7,89,6,0,0,0,0,1,1,3,2,818,0,12,830,0
216,366,343,12,164,2,2,0,1,0,1,2,1,3,897,0,7,904,0
217,405,385,18,148,3,3,3,0,0,1,0,1,3,970,0,10,980,0
218,241,236,18,112,4,1,1,0,0,0,0,1,1,614,0,13,627,0
219,327,287,16,175,3,0,1,0,0,0,0,1,1,811,0,14,825,0
220,313,227,13,136,3,3,0,0,0,3,0,0,4,702,0,8,710,0
221,383,265,14,96,9,1,3,1,0,1,3,0,0,776,0,7,783,0
222,368,271,18,94,4,1,1,0,1,0,0,0,4,762,0,8,770,0
223,306,250,16,192,3,2,6,1,1,2,2,0,1,782,0,12,794,0
224,306,310,7,141,1,0,1,0,0,0,1,1,3,771,0,13,784,0
225,250,223,11,198,2,1,1,2,0,1,0,1,1,691,0,9,700,0
226,241,185,13,140,5,3,1,0,1,1,2,2,0,594,0,10,604,0
227,112,179,12,105,3,2,1,0,0,1,0,0,1,416,0,9,425,0
228,230,246,12,152,0,3,0,1,0,1,2,1,2,650,0,13,663,0
229,290,274,7,83,2,2,2,0,0,0,3,2,4,669,0,11,680,0
230,321,228,17,84,1,0,1,0,1,1,3,3,3,663,0,9,672,0
231,203,218,13,152,0,0,1,0,0,0,1,1,         0    /,589,0,10,599,0
232,219,243,7,109,0,0,4,0,0,1,2,4,2,591,0,5,596,0
233,244,199,12,149,6,0,0,0,0,0,0,3,0,613,0,6,619,0
234,369,231,6,100,9,2,1,1,1,1,0,2,1,724,0,8,732,0
235,270,239,23,120,1,0,2,0,0,0,1,0,2,658,0,9,667,0
236,373,237,5,72,9,0,1,0,1,1,0,1,2,702,0,11,713,0
237,165,198,8,95,2,0,0,0,1,0,0,1,0,470,0,6,476,0
238,179,164,8,87,1,0,1,0,1,0,0,0,1,442,0,2,444,0
239,324,323,14,175,3,2,6,1,0,1,0,2,2,853,0,5,858,0
240,0,0,0,0,0,0,0,0,0,0,0,0,0,0,0,0,0,0
241,195,172,12,56,2,0,1,0,0,0,0,0,0,438,0,4,442,0
242,287,322,10,131,1,1,0,0,1,1,1,3,3,761,0,11,772,0
243,253,261,21,122,2,1,0,0,0,2,0,1,0,663,0,17,680,0
244,145,241,20,105,1,2,1,0,0,0,0,0,0,515,0,3,518,0
245,130,192,31,149,0,1,1,0,0,1,3,0,0,508,0,2,510,0
246,310,258,19,147,1,2,2,1,0,1,2,5,1,749,0,9,758,0
247,332,278,16,112,3,0,2,1,0,1,2,0,1,748,0,14,762,0
248,392,269,16,110,7,3,0,0,0,2,3,0,2,804,0,11,815,0
249,292,199,11,102,15,0,9,1,0,0,1,2,4,636,0,5,641,0
250,53,525,6,49,0,1,1,2,1,2,1,2,10,653,0,9,662,0
251,111,369,21,70,2,0,0,0,1,2,0,0,1,577,0,3,580,0
252,146,467,20,42,2,0,0,0,1,1,2,3,4,688,0,4,692,0
253,274,396,19,58,3,0,1,0,0,1,3,3,5,763,0,8,771,0
254,233,407,14,85,2,1,1,        I,2,0,1,1,6,754,0,10,764,0
255,269,430,7,96,0,1,3,1,3,1,3,1,5,820,0,4,824,0
256,254,321,26,103,0,0,4,0,0,1,0,1,0,710,0,4,714,0
257,209,196,18,79,0,1,2,0,0,1,0,1,2,509,0,6,515,0
258,217,357,13,105,7,0,1,1,0,1,4,1,0,707,0,9,716,0
259,369,356,16,113,3,3,2,0,0,2,0,1,2,867,0,17,884,0
260,188,310,14,68,3,0,1,1,0,0,0,0,0,585,0,3,588,0
261,265,306,32,158,2,0,1,0,0,0,1,2,0,767,0,12,779,0
262,222,275,25,161,1,3,1,0,0,3,2,0,2,695,0,9,704,0
263,334,287,27,188,4,0,1,1,0,0,0,1,0,843,0,13,856,0
264,328,372,20,167,2,1,1,0,1,0,0,1,2,895,0,14,909,0
265,284,132,21,78,1,1,1,0,0,0,0,1,0,519,0,4,523,0
266,229,122,18,58,0,0,0,0,0,0,0,0,0,427,0,5,       4-32,0
267,148,229,13,42,0,0,0,0,0,0,0,0,0,432,0,5,437,0
268,166,252,9,34,1,0,3,0,0,0,0,1,0,466,0,3,469,0
269,211,199,14,83,1,2,0,1,0,1,0,2,0,514,0,3,517,0
270,231,225,16,67,0,0,0,0,1,0,0,1,0,541,0,12,553,0
271,567,398,19,81,3,3,3,3,0,1,2,2,4,1086,      J  0,20,1106,0
272,463,375,18,83,2,1,3,5,0,0,1,1,6,958,0,8,966,0
273,230,235,10,27,0,0,1,1,0,0,0,0,3,507,0,9,516,0
274,258,319,10,77,1,1,1,1,0,0,1,1,4,674,0,4,678,0
275,250,292,18,176,2,2,1,2,0,0,1,1,2,747,0,10,757,0
276,131,674,17,189,5,0,3,2,0,0,1,4,14,1040,0,14,1054,0
277,289,348,19,155,1,0,0,0,0,3,1,1,4,821,0,10,831,0
278,349,410,25,111,1,0,6,1,2,0,0,2,3,910,0,12,922,0
279,265,412,33,146,2,1,0,0,1,3,2,2,1,868,0,11,879,0
280,0,0,0,0,0,0,0,0,0,0,0,0,0,0,0,0,0,0
281,340,280,4,46,2,0,2,0,1,2,3,4,6,690,0,8,698,0
282,386,463,9,48,3,1,0,0,0,0,2,2,5,919,0,8,927,0
283,270,184,17,70,1,1,1,0,2,0,1,0,1,548,0,15,563,0
284,274,159,14,69,2,1,2,0,0,1,0,0,0,522,0,5,527,0
285,231,419,26,91,0,1,1,0,0,0,2,2,1,774,0,12,786,0
286,197,519,27,61,3,1,1,1,0,2,2,2,1,817,0,9,826,0
287,151,295,9,72,1,2,3,0,2,0,1,0,3,539,0,5,544,0
288,150,250,6,83,0,0,2,0,0,0,0,1,2,494,0,5,499,0
289,234,391,37,196,1,1,1,0,0,0,1,3,1,866,0,11,877,0
290,158,280,23,96,2,0,0,0,0,0,0,0,1,560,0,6,566,0
291,164,216,16,53,0,0,0,1,0,1,0,2,1,454,0,7,461,0
292,79,289,10,87,0,0,1,0,1,0,0,1,1,469,0,3,472,0
293,232,601,12,84,1,1,0,0,0,0,1,1,6,939,0,1,940,0
294,30,321,4,7,2,1,0,0,0,0,0,0,2,367,0,0,367,0
295,94,671,23,19,1,0,0,1,0,0,0,2,3,814,0,5,819,0
296,76,336,4,33,2,0,1,0,0,1,1,0,4,458,0,2,460,0
297,59,510,12,15,1,1,0,0,1,1,1,2,5,608,0,5,613,0
298,48,105,1,6,0,0,3,0,0,1,1,0,1,166,0,0,166,0
299,245,693,7,53,4,1,7,0,1,1,2,8,9,1031,0,9,1040,0
300,66,671,14,22,1,1,1,0,0,0,1,3,5,785,0,2,787,0
301,78,566,8,9,0,1,0,0,0,0,1,0,3,666,0,2,668,0
302,58,958,8,9,0,0,0,0,2,0,1,8,12,1056,0,4,1060,0
303,127,782,9,28,0,1,2,0,1,0,0,4,8,962,0,3,965,0
304,99,805,12,17,1,0,1,0,0,0,0,2,6,943,0,5,948,0
305,95,713,14,21,1,0,2,0,0,0,1,3,5,855,0,3,858,0
306,24,498,5,6,0,0,0,0,0,0,0,4,2,539,0,1,540,0
307,80,536,7,6,0,0,0,0,0,0,0,1,2,632,0,6,638,0
1,348,236,20,114,0,1,1,0,0,1,0,3,0,724,0,4,728,0
2,469,429,17,87,2,4,0,0,2,2,0,1,2,1015,0,7,1022,0
3,245,207,13,97,0,0,1,0,0,1,0,0,2,566,0,4,570,0
4,254,287,20,52,2,0,1,0,0,1,0,1,0,618,0,4,622,0
5,270,182,8,55,1,1,0,0,1,0,3,1,0,522,0,5,527,0
6,402,285,16,70,1,0,2,1,0,0,0,2,0,779,0,3,782,0
7,246,241,17,51,2,2,2,0,0,0,0,1,1,563,0,7,570,0
8,379,265,12,88,0,1,1,0,0,0,1,1,2,750,0,14,764,0
9,399,314,21,115,1,0,1,0,0,0,0,0,1,852,0,14,866,0
10,264,214,22,89,0,2,1,1,0,1,0,1,1,596,0,19,615,0
11,140,128,8,61,0,0,0,1,0,0,1,0,1,340,0,6,346,0
12,197,227,9,106,0,0,2,0,0,1,0,0,3,545,0,7,552,0
13,182,167,18,121,0,0,0,0,0,0,0,1,1,490,0,9,499,0
14,205,275,19,100,0,1,0,0,1,2,1,0,0,604,0,4,608,0
15,244,331,7,74,1,1,4,0,0,0,0,0,2,664,0,3,667,0
16,171,177,3,58,1,2,2,0,0,0,1,1,1,417,0,5,422,0
17,151,170,5,99,0,1,0,2,0,1,0,0,0,429,0,7,436,0
18,151,174,9,91,0,1,0,0,0,0,1,1,0,428,0,7,435,0
19,138,138,13,108,2,1,0,0,0,0,0,0,1,401,0,8,409,0
20,189,274,9,78,2,0,0,0,0,0,0,1,0,553,0,9,562,0
21,195,376,18,119,2,2,1,0,0,0,1,2,3,719,0,16,735,0
22,166,303,10,84,0,1,0,1,0,0,0,0,1,566,0,12,578,0
23,176,234,25,134,3,1,0,1,0,0,0,0,0,574,0,9,583,0
24,150,236,22,114,1,2,1,0,0,0,0,0,0,526,0,15,541,0
25,179,398,11,127,1,3,0,0,0,1,1,0,0,721,0,5,726,0
26,176,323,18,119,2,2,0,0,1,0,1,0,1,643,0,8,651,0
27,216,410,18,95,0,5,0,0,0,0,3,1,0,748,0,5,753,0
28,138,230,21,102,1,2,4,0,2,0,2,1,1,504,0,9,513,0
29,178,239,9,112,0,2,0,0,0,0,1,1,0,542,0,3,545,0
30,164,284,17,173,0,4,1,1,0,0,3,0,1,648,0,5,653,0
31,173,308,25,105,2,0,0,2,0,0,2,0,0,617,0,7,624,0
32,120,174,7,85,0,1,1,0,0,0,0,0,0,388,0,5,393,0
33,139,177,9,94,0,1,0,1,0,1,0,0,0,422,0,6,428,0
34,162,298,15,92,0,2,1,0,0,0,0,0,0,570,0,7,577,0
35,257,224,16,91,3,2,1,0,0,0,0,0,3,597,0,6,603,0
36,236,205,9,128,2,3,0,0,0,0,1,1,1,586,0,8,594,0
37,196,149,9,116,0,0,1,0,0,1,1,1,0,474,0,13,487,0
38,311,329,11,49,0,1,0,0,0,0,1,1,4,707,0,11,718,0
39,190,155,16,99,0,0,1,0,0,0,2,1,0,464,0,6,470,0
40,327,337,25,149,0,1,1,1,0,0,1,0,0,842,0,12,854,0
41,159,206,20,152,1,2,1,0,0,0,2,1,1,545,0,6,551,0
42,308,328,23,144,2,2,0,0,0,2,0,0,0,809,0,4,813,0
43,298,266,16,67,1,0,0,0,0,0,3,0,1,652,0,6,658,0
44,409,348,16,85,5,6,3,1,2,2,0,2,3,882,0,11,893,0
45,237,328,6,260,3,1,4,1,1,5,6,12,24,888,0,16,904,0
46,510,158,9,22,0,0,2,1,1,0,0,2,4,709,0,7,716,0
47,219,197,11,58,0,1,0,1,1,1,1,0,0,490,0,9,499,0
48,286,217,10,159,2,3,1,0,0,1,0,0,2,681,0,8,689,0
49,205,287,9,157,0,1,0,0,0,1,0,3,1,664,0,7,671,0
50,194,324,11,134,1,0,0,0,1,0,1,2,2,670,0,12,682,0
51,306,298,21,145,1,2,3,1,1,3,1,2,1,785,0,13,798,0
52,103,216,21,102,2,0,0,2,1,0,1,0,0,448,0,10,458,0
53,133,199,15,115,0,1,0,1,0,1,1,0,1,467,0,7,474,0
54,317,246,15,75,1,3,1,0,0,2,0,1,4,665,0,5,670,0
55,206,276,22,123,1,1,2,0,0,0,3,1,0,635,0,12,647,0
56,172,307,36,148,0,1,0,2,0,0,0,3,1,670,0,15,685,0
57,140,146,9,79,2,1,1,1,0,0,0,0,2,381,0,3,384,0
58,165,207,16,47,1,1,0,0,1,1,2,1,1,443,0,4,447,0
59,571,177,17,76,1,1,1,0,0,0,1,1,3,849,0,10,859,0
60,338,208,17,70,1,2,1,0,2,0,1,2,4,646,0,10,656,0
61,135,140,6,57,0,0,0,0,0,1,0,1,0,340,0,7,347,0
62,102,156,11,74,1,0,0,0,0,0,0,0,0,344,0,5,349,0
63,193,302,29,124,2,0,0,1,0,0,0,2,0,653,0,11,664,0
64,348,173,42,54,3,1,0,1,0,2,0,0,0,624,0,4,628,0
65,420,262,26,78,2,3,1,2,1,1,4,1,1,802,0,8,810,0
66,246,142,17,63,0,0,0,0,0,1,0,0,0,469,0,4,473,0
67,246,263,26,57,2,0,1,0,0,0,1,2,1,599,0,14,613,0
68,199,224,10,59,1,1,3,0,1,1,1,1,5,506,0,6,512,0
69,145,173,12,52,0,2,1,1,0,1,1,0,2,390,0,3,393,0
70,400,165,20,41,0,1,1,0,0,0,0,0,1,629,0,8,637,0
71,260,234,22,95,1,3,0,0,0,2,2,1,0,620,0,8,628,0
72,208,153,12,48,0,1,2,0,0,1,0,0,1,426,0,7,433,0
73,230,164,21,39,0,1,1,0,0,1,0,1,2,460,0,6,466,0
74,293,323,24,41,1,1,1,0,0,0,1,3,1,689,0,8,697,0
75,254,269,21,36,4,1,1,1,0,0,0,2,1,590,0,9,599,0
76,255,246,27,82,1,4,2,0,1,0,1,8,0,627,0,12,639,0
77,149,166,8,69,2,0,0,0,0,0,0,0,0,394,0,9,403,0
78,140,213,5,67,1,1,1,0,0,1,0,0,1,430,0,7,437,0
79,173,142,17,66,1,0,0,0,0,0,0,0,1,400,0,4,404,0
80,157,207,25,101,0,7,2,0,0,0,0,0,0,499,0,16,515,0
81,211,253,20,111,1,1,0,0,0,0,0,0,1,598,0,9,607,0
82,238,273,34,132,2,15,0,0,0,0,0,0,0,694,0,7,701,0
83,145,159,14,35,0,0,0,0,0,3,0,1,1,358,0,2,360,0
84,204,228,23,77,0,2,1,1,0,0,0,0,3,539,0,11,550,0
85,291,271,19,74,0,0,0,1,0,0,0,1,1,658,0,9,667,0
86,247,203,19,49,1,1,0,0,0,0,1,0,1,522,0,5,527,0
87,225,151,17,76,0,3,2,0,0,0,0,1,2,477,0,16,493,0
88,226,270,10,94,1,2,2,1,0,1,1,1,2,611,0,6,617,0
89,240,240,8,56,2,0,0,0,0,1,0,1,2,550,0,6,556,0
90,279,202,20,81,1,1,2,0,0,0,1,0,5,592,0,13,605,0
91,345,162,8,56,1,0,2,0,0,0,1,1,1,577,0,19,596,0
92,260,252,3,49,1,0,0,0,0,2,3,3,6,579,0,4,583,0
93,342,188,15,83,0,0,1,1,0,0,1,0,1,632,0,11,643,0
94,240,306,16,90,2,0,1,1,0,0,0,3,0,659,0,8,667,0
95,247,359,34,171,1,2,1,0,0,0,0,2,2,819,0,3,822,0
96,196,194,9,42,1,0,0,0,0,0,1,1,2,446,0,5,451,0
97,242,341,13,84,3,2,3,0,0,2,3,2,15,710,0,8,718,0
38,298,345,26,84,0,2,1,0,0,0,1,0,1,758,0,11,769,0
39,316,308,23,60,1,7,3,1,0,0,3,4,8,734,0,10,744,0
0,102,154,4,48,2,1,1,0,0,0,3,0,0,315,0,4,319,0
0.01,353,350,11,86,1,0,2,1,1,0,2,0,4,811,0,7,818,0
2,137,173,8,74,2,2,2,0,0,1,-1,1,0,401,0,7,408,0
3,138,181,14,85,0,3,2,1,0,0,1,0,0,425,0,6,431,0
4,522,132,12,32,1,0,3,2,2,2,0,1,1,710,0,7,717,0
5,216,232,8,76,1,3,0,0,0,2,1,1,5,545,0,8,553,0
6,181,194,7,64,0,2,0,0,0,3,1,1,2,455,0,5,460,0
7,288,269,29,93,1,0,1,0,0,2,1,1,0,685,0,14,699,0
8,197,127,10,56,1,1,0,0,0,0,0,0,0,392,0,10,402,0
9,217,239,5,89,0,4,0,0,0,0,1,0,5,560,0,3,563,0
10,249,253,12,62,0,4,1,0,0,0,0,0,2,583,0,6,589,0
11,212,306,8,50,0,2,1,0,0,0,1,0,2,582,0,4,586,0
152,140,242,29,83,1,1,0,0,0,0,0,3,0,499,0,13,512,0
153,129,296,19,94,1,6,0,1,0,0,0,0,0,546,0,9,555,0
154,142,258,16,71,1,0,1,0,0,0,2,0,3,494,0,3,497,0
155,132,243,11,92,0,0,0,0,0,0,0,0,1,479,0,9,488,0
156,225,387,17,92,3,1,2,1,0,0,0,3,1,732,0,16,748,0
157,120,132,11,107,0,2,2,0,0,0,0,2,0,376,0,7,383,0
158,126,176,9,124,1,0,1,0,0,0,2,2,0,441,0,7,448,0
159,171,242,19,116,0,4,0,0,0,0,1,0,0,553,0,8,561,0
160,74,109,7,57,0,0,0,0,0,0,0,0,0,247,0,4,251,0
161,165,211,8,66,0,1,1,0,2,1,0,0,1,456,0,8,464,0
162,93,139,22,61,0,0,0,1,0,0,2,2,1,321,0,0,321,0
163,215,279,8,150,0,2,0,0,0,0,0,1,0,655,0,3,658,0
164,168,347,12,108,1,6,0,0,0,0,0,0,3,645,0,6,651,0
165,167,204,11,148,2,2,2,0,1,0,0,1,1,539,0,10,549,0
166,149,254,12,102,0,2,0,0,1,2,1,1,2,526,0,6,532,0
167,222,316,20,126,3,7,0,0,1,3,1,1,0,700,0,6,706,0
168,138,195,4,64,0,1,0,1,0,1,0,1,0,405,0,6,411,0
169,124,165,20,79,1,1,0,0,0,0,0,0,0,390,0,7,397,0
170,253,279,29,130,1,4,1,0,0,1,2,1,1,702,0,15,717,0
171,158,340,17,75,1,2,0,1,1,1,2,4,1,603,0,8,611,0
172,163,241,15,91,1,1,0,0,0,0,0,0,0,512,0,13,525,0
173,204,222,9,59,1,0,0,0,1,0,1,0,0,497,0,8,505,0
174,171,243,16,106,0,1,3,0,1,0,2,2,1,546,0,9,555,0
175,133,216,16,139,0,3,3,0,0,0,0,0,1,511,0,13,524,0
176,175,344,21,115,0,1,2,0,0,0,0,2,0,660,0,13,673,0
177,187,342,16,116,1,3,1,1,0,2,1,0,0,670,0,24,694,0
178,173,306,14,125,0,11,0,0,1,0,0,1,4,635,0,4,639,0
179,141,200,17,158,2,2,1,0,0,0,0,2,0,523,0,6,529,0
180,101,125,5,46,0,0,0,0,0,0,0,0,0,277,0,4,281,0
181,99,160,4,42,1,0,0,2,0,0,3,0,1,312,0,4,316,0
182,188,253,19,89,0,2,0,0,0,1,0,1,0,553,0,7,560,0
183,151,285,19,126,1,3,1,1,0,1,1,0,1,590,0,12,602,0
184,127,249,9,163,0,0,3,2,0,1,0,0,1,555,0,4,559,0
185,98,198,12,85,1,0,2,0,0,0,2,0,0,398,0,5,403,0
186,125,177,12,108,0,0,3,0,0,1,0,0,0,426,0,7,433,0
187,104,206,21,120,0,1,2,0,0,0,0,1,0,455,0,3,458,0
188,182,193,13,92,1,0,0,0,0,0,0,2,2,485,0,8,493,0
189,163,191,20,85,0,0,1,1,0,0,0,1,1,463,0,12,475,0
190,219,227,12,109,1,0,4,0,0,2,2,1,0,577,0,19,596,0
191,356,269,20,130,5,3,4,0,0,1,0,1,1,790,0,8,798,0
192,194,219,11,214,0,2,0,1,0,0,0,0,2,643,0,14,657,0
193,206,264,12,147,0,4,1,2,0,0,1,0,0,637,0,16,653,0
194,227,297,9,108,1,0,1,0,0,0,1,1,3,648,0,9,657,0
195,168,319,15,170,0,0,0,1,1,2,4,3,3,686,0,8,694,0
196,66,248,11,125,0,0,1,0,0,0,0,3,2,456,0,7,463,0
197,127,170,11,106,0,0,1,0,1,0,0,0,0,416,0,5,421,0
198,181,251,17,118,1,1,0,0,0,1,1,0,0,571,0,4,575,0
199,292,419,22,150,4,1,0,1,0,1,0,1,0,891,0,13,904,0
200,119,241,16,128,1,0,1,1,0,0,1,1,1,510,0,6,516,0
201,281,312,23,174,2,1,0,0,0,0,2,0,0,795,0,14,809,0
202,144,183,11,107,0,1,0,0,0,0,0,1,1,448,0,5,453,0
203,196,255,12,141,3,2,0,3,1,0,4,0,1,618,0,9,627,0
204,189,99,7,67,1,2,0,0,0,0,0,1,2,368,0,4,372,0
205,220,317,31,180,1,2,0,0,0,0,0,2,1,754,0,14,768,0
206,350,374,8,269,2,1,6,0,2,0,4,1,6,1023,0,14,1037,0
207,152,294,15,174,3,0,1,0,0,1,1,0,2,643,0,12,655,0
208,349,324,17,142,2,4,3,1,0,0,3,1,4,850,0,10,860,0
209,125,99,9,78,0,0,1,0,0,1,2,1,0,316,0,4,320,0
210,172,191,10,103,0,2,3,1,0,0,0,1,0,483,0,5,488,0
211,170,224,12,99,2,2,1,0,0,0,1,1,1,513,0,8,521,0
212,351,256,19,256,1,1,0,0,0,1,0,1,5,891,0,13,904,0
213,258,195,9,152,1,2,2,1,2,0,2,1,0,625,0,8,633,0
214,204,188,11,199,1,1,2,1,1,1,1,3,1,614,0,5,619,0
215,278,220,13,184,1,0,2,0,0,0,0,1,1,700,0,8,708,0
216,277,349,22,185,1,1,4,2,0,1,1,1,1,845,0,7,852,0
217,174,252,15,153,4,1,3,1,0,0,2,0,2,607,0,8,615,0
218,156,149,16,126,0,0,0,1,0,1,0,0,3,452,0,8,460,0
219,283,377,30,134,3,1,0,0,0,1,1,2,1,833,0,16,849,0
220,217,247,11,160,2,1,1,1,1,0,3,2,4,650,0,5,655,0
221,207,296,7,200,2,1,3,0,0,0,2,3,3,724,0,6,730,0
222,278,290,14,208,3,4,0,0,0,0,1,0,0,798,0,17,815,0
223,287,303,22,245,4,2,1,1,0,0,1,0,1,867,0,12,879,0
224,206,161,12,143,3,1,1,0,0,1,4,0,2,534,0,4,538,0
225,284,262,24,173,3,1,1,1,1,1,1,3,2,757,0,8,765,0
226,184,193,8,112,0,3,0,3,0,1,2,1,2,509,0,5,514,0
227,157,201,7,130,0,4,2,0,0,0,2,0,2,505,0,4,509,0
228,380,341,13,247,3,1,5,3,2,0,4,5,8,1012,0,7,1019,0
229,363,309,13,240,1,3,4,1,1,3,2,1,4,945,0,6,951,0
230,253,332,15,167,1,1,0,0,0,0,0,0,0,769,0,6,775,0
231,249,265,21,143,1,0,1,0,0,0,0,0,0,680,0,12,692,0
232,189,140,10,91,0,1,0,0,0,0,2,1,2,436,0,12,448,0
233,150,153,13,84,0,0,0,1,0,0,0,0,0,401,0,9,410,0
234,125,109,6,127,1,2,0,0,1,0,0,0,0,371,0,11,382,0
235,144,174,12,123,0,9,0,0,1,0,0,0,2,465,0,5,470,0
236,321,168,20,61,0,2,0,0,0,0,1,0,1,574,0,7,581,0
237,303,67,21,50,0,0,0,0,0,0,0,0,0,441,0,5,446,0
238,291,405,18,229,3,2,5,1,3,0,3,1,2,963,0,7,970,0
239,385,322,17,200,6,4,4,0,2,2,3,4,7,956,0,8,964,0
240,253,258,4,171,0,4,0,1,0,0,1,3,7,702,0,11,713,0
241,275,239,12,131,1,2,2,1,0,2,1,1,5,672,0,7,679,0
242,176,185,4,145,2,0,1,2,1,2,2,2,1,523,0,4,527,0
243,230,187,10,133,1,0,1,0,1,1,2,0,3,569,0,3,572,0
244,206,207,14,137,1,3,0,0,0,0,1,0,2,571,0,10,581,0
245,238,315,13,204,1,3,3,0,0,0,2,2,2,783,0,1,784,0
246,259,250,17,256,3,4,2,1,0,1,3,0,0,796,0,10,806,0
247,168,169,9,179,2,3,2,0,0,2,2,2,2,540,0,4,544,0
248,175,184,14,160,0,1,0,1,0,1,1,0,1,538,0,11,549,0
249,195,200,15,117,0,1,0,0,0,0,1,1,0,530,0,11,541,0
250,184,190,15,161,2,3,2,0,0,0,2,2,3,564,0,11,575,0
251,203,321,16,282,1,2,0,0,0,0,0,0,0,825,0,9,834,0
252,226,202,8,172,2,1,1,0,1,1,1,0,2,617,0,17,634,0
253,180,288,15,277,0,1,2,1,0,0,1,3,3,771,0,6,777,0
254,138,273,17,277,1,3,6,1,0,0,6,0,4,726,0,9,735,0
255,181,157,15,88,1,3,0,0,1,0,2,1,1,450,0,7,457,0
256,162,206,14,182,1,1,0,0,1,1,1,4,3,576,0,1,577,0
257,328,376,20,286,1,0,4,0,1,1,1,1,4,1023,0,8,1031,0
258,127,111,3,162,1,3,1,0,0,1,0,1,1,411,0,2,413,0
259,281,319,22,205,2,10,2,0,1,1,1,3,3,850,0,7,857,0
260,137,151,9,150,1,2,2,0,0,0,1,0,2,455,0,7,462,0
261,162,150,12,113,2,2,4,1,0,0,1,0,1,448,0,6,454,0
262,351,322,20,198,3,2,3,2,0,1,2,1,2,907,0,9,916,0
263,368,362,18,197,2,3,8,1,1,1,4,1,5,971,0,12,983,0
264,219,294,16,218,0,0,2,0,0,0,2,1,4,756,0,7,763,0
265,224,325,16,163,2,3,1,1,0,2,0,3,4,744,0,10,754,0
266,246,356,12,277,2,4,1,2,0,0,2,1,3,906,0,12,918,0
267,216,350,16,211,4,8,0,0,0,1,0,2,1,809,0,9,818,0
268,145,236,30,186,0,1,1,2,0,0,2,2,1,606,0,9,615,0
269,192,170,24,199,1,3,1,0,0,1,0,0,0,591,0,8,599,0
270,142,137,18,128,1,0,0,0,1,0,0,0,0,427,0,9,436,0
271,154,194,17,111,0,1,0,0,0,0,0,1,0,478,0,10,488,0
312,368,335,3,86,3,1,1,0,2,0,2,2,1,804,0,12,816,1
313,388,384,11,64,2,2,1,0,0,1,1,2,2,858,0,18,876,0
314,366,362,12,56,1,1,0,0,0,1,2,4,10,815,0,20,835,0
315,291,386,15,90,1,2,2,3,1,0,2,2,4,799,0,7,806,0
316,216,205,10,106,0,1,0,0,0,0,0,3,3,544,0,7,551,0
317,174,171,15,117,2,1,0,0,3,1,0,1,2,487,0,11,498,0
318,195,328,13,197,2,1,1,0,0,0,0,0,0,737,0,13,750,0
319,93,427,4,77,1,2,1,1,0,0,0,2,1,609,0,3,612,0
320,238,353,13,75,1,3,3,1,0,0,2,0,4,693,0,11,704,0
321,285,445,14,110,1,1,1,0,0,1,1,1,3,863,0,7,870,0
322,30,744,32,79,1,1,0,0,0,0,0,2,3,892,0,7,899,0
323,145,599,23,112,2,4,2,0,0,1,1,0,1,890,0,5,895,0
324,189,246,18,90,0,4,1,0,0,1,0,0,0,549,0,11,560,0
325,290,261,23,80,1,3,1,0,0,1,2,0,0,662,0,6,668,0
326,203,375,28,170,0,0,1,1,1,0,1,3,1,784,0,5,789,0
327,276,461,21,164,2,2,0,2,2,0,2,0,4,936,0,13,949,0
32S,120,231,10,68,2,0,1,0,0,0,1,0,3,436,0,5,441,0
329,146,213,9,78,1,2,0,0,0,0,0,0,0,449,0,7,456,0
330,210,393,29,75,0,0,1,0,1,0,0,1,0,710,0,10,720,0
331,261,278,9,67,1,2,1,1,0,1,0,1,3,625,0,4,629,0
332,301,421,11,187,0,2,3,0,1,3,1,0,2,932,0,6,938,0
333,392,379,20,87,2,0,1,0,0,1,0,0,1,883,0,16,899,0
334,413,389,15,74,2,1,1,0,1,2,0,1,1,900,0,3,903,0
335,516,393,16,112,3,1,2,1,1,0,1,3,1,1050,0,10,1060,0
336,99,584,26,117,2,1,2,0,0,0,1,0,6,838,0,5,843,0
337,95,349,15,102,2,1,2,0,0,2,0,2,0,570,0,6,576,0
338,324,377,21,109,4,3,1,0,1,6,2,4,5,857,0,9,866,0
339,332,338,18,67,4,1,3,3,0,1,1,5,8,781,0,4,785,0
340,344,265,15,108,1,0,0,1,0,1,1,1,2,739,0,4,743,0
341,21,478,21,90,0,0,0,0,0,1,2,1,8,622,0,5,627,0
342,4,428,21,50,0,1,0,0,0,0,2,1,2,509,0,2,511,0
343,42,583,23,95,0,0,0,0,0,0,0,1,4,748,0,4,752,0
344,239,375,18,101,3,0,1,0,0,0,0,1,3,741,0,5,746,0
345,212,507,22,94,4,0,5,0,1,0,1,2,1,849,0,15,864,0
346,375,350,19,117,1,3,2,0,0,0,2,1,0,870,0,10,880,0
145,141,236,11,79,0,4,1,1,1,0,0,1,2,477,0,9,486,0
279,146,163,20,75,1,2,0,1,0,0,0,0,3,411,0,5,416,0
1,37,380,46,5,0,0,0,0,1,0,0,0,1,470,0,4,474,0
2,26,414,94,3,2,0,0,1,1,1,0,1,1,544,0,6,550,0
3,13,320,55,4,0,0,0,0,0,0,0,2,3,397,0,3,400,0
4,26,526,122,8,0,0,1,0,0,2,1,0,4,690,0,4,694,0
5,                      IS,554,116,10,3,1,2,0,0,1,2,6,7,717,0,5,722,0
6,25,640,131,4,1,0,0,1,0,0,1,5,11,819,0,5,824,0
7,35,400,41,5,0,0,0,0,0,0,1,2,3,487,0,2,489,0
8,19,422,95,9,0,0,0,1,0,1,0,2,3,552,0,1,553,0
9,22,695,158,4,1,1,1,0,1,1,0,3,12,899,0,4,903,0
10,14,578,114,7,1,1,0,0,0,2,1,3,6,727,0,10,737,0
11,14,517,98,2,0,0,1,0,0,1,0,2,1,636,0,4,640,0
12,10,407,125,3,1,0,0,0,2,2,1,5,3,559,0,3,562,0
13,13,523,140,12,2,0,0,0,0,1,0,1,8,700,0,2,702,0
14,26,206,17,4,0,0,1,0,0,1,0,0,3,258,0,2,260,0
15,17,503,176,4,0,0,1,0,0,1,0,6,9,717,0,3,720,0
16,23,378,142,6,0,0,0,0,3,1,2,1,5,561,0,5,566,0
17,6,376,124,6,0,0,1,0,0,0,1,3,4,521,0,0,521,0
18,9,349,97,2,0,0,1,1,0,0,1,0,5,465,0,5,470,0
19,25,537,51,2,2,0,0,1,0,0,0,0,7,625,0,1,626,0
20,12,559,72,3,3,2,0,0,0,2,1,2,8,664,0,3,667,0
21,32,456,47,7,2,0,0,0,0,1,1,1,0,547,0,4,551,0
22,50,432,42,7,2,1,1,0,1,0,0,1,14,551,0,4,555,0
23,24,264,31,12,0,0,0,1,0,1,1,2,3,339,0,4,343,0
24,23,560,81,3,1,0,0,0,0,0,0,4,2,674,0,9,683,0
25,38,492,115,12,4,0,0,0,0,2,1,4,5,673,0,6,679,0
26,5,393,55,14,0,1,0,0,0,2,0,1,16,487,0,6,493,0
27,6,415,58,7,3,0,0,0,0,0,1,6,13,509,0,7,                    S16,0
28,19,573,103,7,2,1,2,3,0,0,1,2,6,719,0,7,726,0
29,10,445,224,11,3,0,1,0,0,1,1,2,9,707,0,8,715,0
30,5,392,113,1,1,0,0,0,1,0,1,0,8,522,0,6,528,0
31,48,505,51,2,1,0,0,1,0,0,0,3,15,626,0,12,638,0
32,20,580,80,6,0,0,0,1,1,0,0,2,4,694,0,4,698,0
33,137,299,24,5,0,0,2,0,0,0,1,3,2,473,0,3,476,0
34,241,                     1        343,51,12,0,0,1,0,0,2,0,2,6,658,                     1             0,10,668,0
35,41,582,93,3,1,0,0,0,0,1,1,0,1,723,0,7,730,0
36,70,334,54,2,0,0,0,0,0,0,0,2,2,464,0,5,469,0
37,28,447,97,3,0,1,0,0,2,0,2,3,5,588,0,6,594,0
38,15,388,82,4,0,2,1,0,0,0,1,2,4,499,0,2,501,0
39,42,576,48,11,0,0,0,1,0,2,2,3,14,699,0,10,709,0
40,135,380,122,17,0,0,0,0,1,3,4,14,14,690,0,12,702,0
41,13,291,31,7,0,1,0,0,0,1,1,1,0,346,0,3,349,0
42,259,329,61,54,0,2,0,0,0,1,1,1,2,710,0,4,714,0
43,10,518,46,4,0,0,0,1,1,0,0,4,6,590,0,5,595,0
44,3,326,74,3,1,1,1,0,1,0,0,4,2,416,0,8,424,0
45,16,634,98,13,1,0,0,1,2,1,1,1,4,111,0,4,776,0
46,9,359,57,3,2,0,0,1,1,0,4,1,9,446,0,3,449,0
47,12,579,63,5,1,0,0,1,0,1,0,1,2,665,0,1,666,0
48,71,414,27,9,0,0,0,0,0,0,0,0,5,526,0,0,526,0
49,46,759,85,14,2,0,0,0,1,0,2,4,13,926,0,7,933,0
50,60,700,113,11,0,0,0,0,0,1,3,0,14,902,0,8,910,0
51,131,376,56,6,3,0,0,0,0,0,0,3,7,582,0,10,592,0
52,7,178,81,4,1,0,0,1,0,0,0,1,2,275,0,2,277,0
53,35,538,129,13,1,0,0,0,0,0,2,3,6,727,0,4,731,0
54,10,495,60,2,0,0,0,0,0,1,1,2,6,577,0,6,583,0
55,6,583,50,8,2,0,0,0,0,0,0,2,5,656,0,3,659,0
56,1,523,51,3,0,0,0,0,0,0,1,2,6,587,0,7,594,0
57,60,108,10,16,0,1,0,1,0,1,0,2,3,202,0,2,204,0
58,426,219,15,53,0,0,0,0,0,2,1,2,2,720,0,6,726,0
59,418,172,8,164,1,0,0,0,1,2,3,2,3,774,0,5,779,0
60,337,242,16,17,0,1,0,0,0,0,1,3,9,626,0,4,630,0
61,269,144,9,9,0,1,0,0,1,0,1,0,5,439,0,7,446,0
62,41,673,109,4,0,1,3,1,0,1,2,3,10,848,0,17,865,0
63,192,87,11,20,0,0,0,1,1,1,0,0,2,315,0,1,316,0
64,172,366,74,26,1,1,1,3,2,1,0,2,3,652,0,4,656,0
65,27,644,101,5,0,2,1,0,3,0,0,4,9,796,0,5,801,0
66,64,519,54,11,0,1,2,1,1,0,1,1,7,662,0,4,666,0
67,10,261,27,2,1,0,0,1,0,0,0,4,2,308,0,4,312,0
68,3,234,21,0,0,0,0,0,1,1,0,2,3,265,0,3,268,0
69,26,676,73,6,4,1,0,0,1,0,0,0,,796,0,7,803,0
70,43,368,56,11,0,0,0,1,0,0,0,4,6,489,0,8,497,0
71,233,321,24,80,0,1,2,1,0,1,1,1,5,670,0,8,678,0
72,230,192,33,74,0,0,0,0,0,1,0,1,0,531,0,11,542,0
73,397,226,20,32,1,0,0,0,1,0,0,3,2,682,0,9,691,0
74,188,153,9,39,1,2,0,1,0,0,1,2,0,396,0,4,400,0
75,89,216,12,14,0,1,0,2,0,0,1,2,4,341,0,5,346,0
76,43,605,94,9,                    .    1,1,0,0,0,2,2,3,11,771,0,14,785,0
77,84,407,37,33,2,0,0,1,2,0,0,1,3,570,0,1,571,0
78,284,298,78,43,2,3,0,0,1,0,0,1,1,711,0,8,719,0
79,229,190,3,65,0,1,1,0,0,0,0,1,2,492,0,3,495,0
80,218,187,5,59,0,0,0,1,0,0,0,1,0,471,0,2,473,0
81,377,255,11,58,0,1,0,0,0,1,0,2,5,710,0,8,718,0
82,250,273,7,95,2,2,0,0,2,0,0,2,1,634,0,8,642,0
83,215,211,14,75,1,0,1,1,1,0,1,0,1,521,0,5,526,0
84,361,70,3,17,1,3,1,0,0,2,0,0,1,459,0,1,460,0
85,329,187,17,60,0,0,2,0,0,2,2,4,2,605,0,10,615,0
86,305,172,13,2,1,0,0,0,2,1,3,0,2,501,0,0,501,0
87,135,277,26,6,3,0,0,0,0,1,0,2,3,453,0,8,461,0
88,36,387,32,7,0,0,1,0,1,1,1,1,6,473,0,7,480,0
89,254,137,35,3,3,0,0,1,0,2,0,0,1,436,0,2,438,0
90,250,144,15,9,0,1,0,0,0,2,1,0,0,422,0,3,425,0
91,407,188,26,16,1,1,0,0,0,0,0,2,0,641,0,8,649,0
92,190,111,21,10,3,0,0,0,1,1,0,0,0,337,0,8,345,0
93,183,95,9,6,1,0,0,0,0,2,1,2,0,299,0,5,304,0
94,143,46,6,12,0,0,0,0,0,0,0,0,1,208,0,2,210,0
95,320,149,12,1,7,0,0,0,0,0,0,2,1,492,0,5,497,0
96,245,111,5,4,0,1,0,0,0,0,1,0,5,372,0,3,375,0
97,191,215,12,1,4,1,0,0,0,2,0,1,5,432,0,2,434,0
98,125,105,6,0,2,0,0,0,3,1,0,0,3,245,0,2,247,0
99,229,272,15,16,1,0,0,0,0,2,1,2,4,542,0,2,544,0
100,236,123,34,3,1,0,2,1,0,0,0,2,1,403,0,8,411,0
101,246,111,12,2,0,0,1,0,1,1,0,0,2,376,0,1,377,0
102,133,89,7,4,0,0,0,0,0,0,0,1,2,236,0,1,237,0
103,189,153,25,4,4,0,1,0,0,1,2,4,,385,0,4,389,0
104,92,92,4,5,0,1,1,0,0,0,0,1,,199,0,1,200,0
                     ICS,206,250,6,9,1,0,0,0,0,0,0,2,5,479,0,13,492,0
106,267,125,3,0,1,1,1,0,0,1,0,1,7,407,0,11,418,0
107,469,146,3,3,0,1,3,0,0,2,0,0,4,631,0,8,639,0
108,420,207,9,4,1,4,0,1,2,2,3,7,14,674,0,10,684,0
109,202,385,13,23,0,1,2,0,1,4,4,7,35,677,0,22,699,0
110,219,146,11,6,0,0,0,0,0,1,2,0,4,389,0,2,391,0
111,221,146,10,11,0,0,0,0,1,1,1,1,4,396,0,2,398,0
112,236,157,3,6,3,1,1,1,2,1,2,1,5,419,0,5,424,0
113,258,                  ?   220,18,8,2,0,0,0,0,2,1,3,4,516,0,2,518,0
114,314,316,10,13,1,1,0,1,0,2,0,1,9,668,0,11,679,0
115,313,120,9,1,0,3,1,0,0,1,0,2,3,453,0,10,463,0
116,278,147,7,2,0,0,1,0,0,0,0,0,3,438,0,6,444,0
117,321,51,5,0,0,0,0,0,0,0,0,0,1,378,0,1,379,0
118,293,116,7,2,0,0,0,0,0,0,0,0,2,420,0,3,423,0
119,367,72,10,2,0,2,0,0,0,0,0,3,5,461,0,3,464,0
120,344,122,6,5,0,4,1,1,1,0,0,1,7,492,0,5,497,0
121,310,391,30,9,1,3,1,0,1,0,3,1,7,757,0,10,767,0
122,376,168,15,7,0,2,1,1,1,0,2,1,1,575,0,6,581,0
123,535,50,2,5,0,0,1,0,0,0,1,0,1,595,0,4,599,0
124,621,77,7,6,0,1,1,1,0,1,0,2,2,719,0,6,725,0
125,575,79,17,11,2,0,0,0,0,1,1,1,1,688,0,6,694,0
126,405,31,4,0,1,0,0,0,0,0,1,1,5,448,0,3,451,0
127,413,36,2,5,3,2,0,0,0,0,0,1,2,464,0,6,470,0
128,268,109,5,10,2,0,0,0,0,0,0,0,1,395,0,4,399,0
129,503,51,9,13,0,0,0,0,0,1,0,1,0,578,0,7,585,0
130,390,41,1,3,0,1,0,0,0,1,1,1,1,440,0,2,442,0
131,463,81,18,6,1,0,1,0,2,2,2,1,2,579,0,6,585,0
132,427,54,5,13,0,0,0,0,0,0,0,0,0,499,0,2,501,0
133,426,106,7,3,1,0,0,0,0,0,0,1,0,544,0,1,545,0
134,275,18,8,3,0,0,1,1,0,0,0,1,0,307,0,7,314,0
135,252,171,8,16,2,1,0,0,0,1,0,2,5,458,0,5,463,0
136,414,251,18,1,1,0,0,2,0,1,1,2,1,692,0,4,696,0
137,597,95,14,2,1,7,0,0,0,2,2,4,3,727,0,7,734,0
138,20,545,17,7,2,                             c,0,0,0,0,                              c,1,5,597,                   c,6,603,0
                          13S,285,                       20C,1,8,                               C,1,0,                   c,1,                    c,1,1,5,                           51S,                   c,,                           52S,0
140,250,178,10,5,0,0,0,0,0,2,0,0,2,447,0,4,451,0
141,76,605,29,28,1,0,0,0,0,0,0,2,5,746,0,5,751,0
142,301,358,44,5,1,0,2,0,0,1,0,2,2,716,0,4,720,0
143,163,379,32,9,1,0,0,0,1,0,0,1,4,590,0,4,594,0
144,143,363,45,12,2,0,0,0,0,1,1,2,1,570,0,3,573,0
145,93,430,22,13,1,0,1,1,0,0,1,2,4,568,0,4,572,0
146,65,647,41,20,2,0,0,0,1,0,0,1,4,781,0,3,784,0
147,289,278,18,7,0,0,0,0,0,2,0,0,1,595,0,3,598,0
148,56,252,12,2,0,0,0,0,0,1,1,0,1,325,0,2,327,0
149,267,41,4,2,1,0,0,0,0,0,0,0,0,315,0,2,317,0
150,388,94,7,8,2,1,0,0,0,0,0,0,2,502,0,7,509,0
151,176,67,5,10,2,0,1,0,0,1,0,0,1,263,0,11,274,0
152,551,179,15,12,4,1,0,2,1,3,1,5,3,777,0,22,799,0
153,91,62,15,4,0,1,0,0,0,0,0,0,0,173,0,2,175,0
154,157,69,6,7,0,0,1,0,0,0,0,0,0,240,0,4,244,0
155,12,461,26,6,1,0,0,0,0,1,0,0,1,508,0,1,509,0
156,213,233,5,4,2,0,0,0,0,0,0,2,3,462,0,6,468,0
157,113,574,59,20,0,0,0,0,0,1,0,0,2,769,0,1,770,0
158,8,261,16,13,0,0,0,0,1,0,1,3,0,303,0,4,307,0
159,15,618,25,18,0,1,0,0,0,0,1,2,5,685,0,3,688,0
160,151,419,52,29,0,1,0,0,1,1,0,1,2,657,0,3,660,0
161,87,497,42,11,1,1,1,0,0,1,0,0,1,642,0,3,645,0
162,79,564,24,10,2,0,0,2,0,0,0,2,2,685,0,4,689,0
163,284,330,20,16,0,1,0,0,0,0,0,0,0,651,0,9,660,0
164,127,362,28,7,2,1,0,0,0,1,0,0,0,528,0,3,531,0
165,79,281,14,3,0,1,0,0,0,0,0,0,0,378,0,1,379,0
166,35,534,30,6,1,0,0,0,1,0,0,3,2,612,0,2,614,0
167,16,530,24,4,0,0,0,0,0,1,0,0,2,577,0,4,581,0
168,40,327,15,8,0,0,0,0,0,0,0,0,2,392,0,0,392,0
169,19,610,47,11,1,1,0,0,0,0,0,2,2,693,0,4,697,0
170,36,785,41,9,2,7,0,2,2,2,2,5,6,899,0,3,902,0
171,22,741,30,13,0,0,0,1,0,1,1,0,4,813,0,6,819,0
172,278,274,22,4,4,1,0,0,0,0,1,2,8,594,0,4,598,0
173,157,317,19,4,                             C,0,0,0,0,0,1,1,1,                   50C,                              c,2,502,0
174,180,423,32,5,2,1,1,1,              1        0,1,1,4,8,                   65S,                              c,8,667,0
175,7,359,29,2,0,1,0,0,0,0,1,0,5,404,0,2,406,0
176,23,268,25,8,1,1,0,0,0,0,3,3,5,337,0,4,341,0
177,280,286,15,10,0,0,0,0,0,0,1,1,2,595,0,2,597,0
178,131,522,23,3,1,0,1,0,1,0,0,1,8,691,0,5,696,0
179,46,628,37,5,1,0,2,0,0,0,0,4,8,731,0,2,733,0
180,255,402,30,6,0,0,0,0,0,1,2,4,6,706,0,8,714,0
181,9,571,11,0,0,0,0,0,0,0,0,0,7,598,0,4,602,0
182,15,574,38,8,1,0,0,0,0,0,0,0,4,640,0,2,642,0
183,102,413,31,15,0,0,1,0,0,0,1,3,2,568,0,4,572,0
184,24,641,34,8,0,0,1,0,0,0,0,1,5,714,0,1,715,0
185,34,368,29,11,1,1,1,1,0,0,0,1,0,447,0,1,448,0
186,194,479,22,15,0,1,0,1,0,2,0,2,2,718,0,2,720,0
187,12,472,32,2,1,0,0,0,0,0,1,1,2,523,0,5,528,0
188,20,368,22,8,1,1,0,0,0,0,1,1,1,423,0,1,424,0
189,593,153,25,4,1,0,2,2,3,1,2,4,8,798,0,9,807,0
190,36,615,18,14,2,2,0,0,1,0,0,2,6,696,0,4,700,0
191,111,334,24,6,0,1,1,0,0,1,0,1,1,480,0,6,486,0
192,54,519,20,33,1,7,0,0,0,0,0,0,1,635,0,1,636,0
193,7,551,37,11,4,0,0,0,0,0,1,3,7,621,0,6,627,0
194,90,567,62,20,6,0,1,0,0,0,2,5,6,759,0,11,770,0
195,23,580,32,13,3,1,1,0,0,0,1,2,5,661,0,4,665,0
196,104,605,20,11,1,0,0,0,0,1,2,2,7,753,0,4,757,0
197,205,410,20,2,1,0,0,1,1,0,1,1,2,644,0,8,652,0
198,140,368,20,5,0,0,0,1,1,0,0,2,5,542,0,4,546,0
199,165,529,16,7,0,1,0,0,0,1,0,0,3,722,0,8,730,0
200,340,213,7,5,1,1,0,0,0,0,0,2,7,576,0,9,585,0
201,16,549,22,7,1,1,0,0,0,0,0,1,3,600,0,4,604,0
202,12,372,22,24,1,0,0,0,0,1,0,0,0,432,0,4,436,0
203,613,142,13,4,4,2,1,1,3,4,2,2,2,793,0,12,805,0
204,678,128,16,0,1,1,1,0,2,5,1,3,8,844,0,28,872,0
205,84,397,16,5,3,1,0,0,0,0,1,1,5,513,0,2,515,0
206,282,275,19,6,0,3,0,0,0,0,0,0,6,591,0,7,598,0
207,298,207,11,14,0,0,1,0,0,3,1,1,0,536,0,7,543,0
208,128,225,24,21,1,0,0,0,0,0,1,1,                      C,401,                              c,3,404,0
209,233,373,27,15,                     26|       1,,0,1,0,0,       1        0,2,0,678,       1        c,3,681,0
210,258,200,14,22,0,0,0,0,0,1,2,0,0,497,0,2,499,0
211,217,296,16,34,2,0,0,0,0,0,0,2,1,568,0,5,573,0
212,113,353,16,6,1,0,0,0,0,0,0,0,2,491,0,3,494,0
213,183,275,33,38,1,1,0,0,1,0,1,1,4,538,0,5,543,0
214,244,201,16,58,2,1,0,0,0,0,0,0,0,522,0,7,529,0
215,371,124,25,48,1,0,0,0,0,0,1,0,1,571,0,7,578,0
216,332,119,24,48,1,11,1,2,0,2,0,1,1,542,0,3,545,0
217,137,246,21,22,0,0,0,1,1,0,0,1,4,433,0,1,434,0
218,165,138,9,52,0,0,1,2,0,0,0,0,0,367,0,14,381,0
219,204,               ... 125,19,13,0,3,0,1,1,0,1,2,0,369,0,6,375,0
220,253,147,16,24,1,2,0,0,0,0,0,0,1,444,0,4,448,0
221,88,195,16,9,1,0,0,0,0,0,2,0,0,311,0,6,317,0
222,51,454,24,19,1,0,0,0,0,0,1,3,1,554,0,6,560,0
223,31,416,11,19,1,0,0,0,0,0,0,1,6,485,0,2,487,0
224,39,491,26,32,1,0,0,0,1,0,1,2,6,599,0,3,602,0
225,71,444,36,19,0,0,1,1,1,0,0,1,6,580,0,7,587,0
226,315,178,41,28,1,1,1,0,0,0,0,0,0,565,0,7,572,0
227,273,168,33,41,0,0,0,0,0,1,0,1,0,517,0,10,527,0
228,322,174,19,40,0,3,0,1,0,2,1,0,1,563,0,1,564,0
229,302,165,24,33,0,0,0,0,0,3,0,0,1,528,0,11,539,0
230,215,142,6,19,0,2,0,1,0,1,0,1,1,388,0,9,397,0
231,264,213,23,43,0,3,1,1,1,0,0,0,0,549,0,7,556,0
232,324,300,18,13,0,0,0,0,1,0,0,0,2,658,0,5,663,0
233,450,184,26,25,1,0,0,1,1,2,1,0,0,691,0,2,693,0
234,254,326,24,21,1,1,1,0,2,1,1,0,2,634,0,3,637,0
235,287,131,16,25,1,1,0,0,0,0,0,1,1,463,0,5,468,0
236,279,130,22,25,0,2,0,0,0,0,0,0,1,459,0,4,463,0
237,246,133,4,19,1,0,1,1,0,0,0,                    I,0,406,0,2,408,0
238,215,119,3,13,0,0,1,1,0,1,1,0,3,357,0,2,359,0
239,253,171,6,45,0,0,0,1,0,1,1,1,10,489,0,10,499,0
240,97,428,7,41,1,1,0,0,0,1,2,5,6,589,0,5,594,0
241,354,141,16,15,0,0,0,0,1,0,0,1,3,531,0,1,532,0
242,60,10,3,1,0,0,0,0,0,0,                     c,0,0,74,0,1,75,0
243,434,194,14,22,0,0,0,0,1,0,0,1,1,667,0,7,674,0
                 1     244,373,126,11,13,0,0,1,1,0,0,2,0,5,532,                             c,12,544,0
245,182,120,14,4,0,0,0,0,0,0,0,1,1,322,0,1,323,0
246,375,139,4,13,3,1,0,0,0,0,0,1,2,538,0,7,545,0
247,76,469,41,37,1,1,0,0,1,0,0,1,9,636,0,9,645,0
248,19,585,32,31,1,0,0,0,3,3,1,3,12,690,0,7,697,0
249,19,524,31,35,1,1,0,0,0,0,1,2,9,623,0,1,624,0
250,203,77,10,52,0,1,0,0,0,0,2,1,3,349,0,1,350,0
251,149,96,5,6,0,0,0,0,0,0,1,1,0,258,0,3,261,0
252,323,188,12,28,1,0,0,0,3,0,0,3,4,562,0,11,573,0
253,61,314,21,33,0,0,0,0,0,0,1,0,0,430,0,4,434,0
254,20,484,24,47,1,0,0,0,0,1,1,1,4,583,0,5,588,0
255,5,344,19,100,1,0,3,0,0,0,0,0,3,475,0,4,479,0
256,325,                  ?  135,14,6,0,0,0,0,0,0,1,0,1,482,0,6,488,0
257,293,126,12,15,0,1,0,0,2,1,2,2,2,456,0,3,459,0
258,389,107,2,22,1,0,0,1,1,1,1,0,5,530,0,8,538,0
259,293,99,4,37,0,0,0,0,0,0,0,0,0,433,0,5,438,0
260,203,45,7,17,0,0,0,0,0,0,0,0,1,273,0,3,276,0
261,227,262,9,19,2,0,0,0,0,0,1,1,2,523,0,1,524,0
262,266,90,41,7,0,0,0,0,0,1,0,0,0,405,0,2,407,0
263,108,132,9,10,0,0,0,0,1,0,0,5,3,268,0,3,271,0
1,221,114,19,21,0,0,0,0,0,0,0,0,1,376,0,7,383,0
2,226,142,25,13,0,1,1,0,0,1,0,0,3,412,0,3,415,0
3,78,198,11,7,0,0,1,0,0,0,0,0,1,296,0,2,298,0
4,7,387,14,2,0,0,0,0,0,0,0,1,2,413,0,2,415,0
5,16,240,10,1,0,0,0,0,0,0,1,0,3,271,0,1,272,0
6,124,200,34,23,0,0,0,0,0,0,1,1,0,383,0,8,391,0
7,14,535,27,9,1,0,0,0,0,0,0,1,0,587,0,8,595,0
8,126,289,23,12,0,0,0,0,0,0,0,0,1,451,0,2,453,0
9,13,423,19,10,1,0,0,0,1,0,0,1,2,470,0,2,472,1
10,209,143,16,12,1,1,0,0,0,0,0,0,0,382,0,3,385,0
11,117,69,6,4,0,0,0,0,0,0,0,1,0,197,0,0,197,0
12,83,501,26,7,1,0,1,0,1,1,0,0,4,625,0,2,627,0
13,339,81,12,12,0,1,0,0,0,0,0,0,0,445,0,9,454,0
14,208,39,11,4,0,0,0,0,0,0,1,0,0,263,0,1,264,0
15,360,104,19,11,0,0,1,0,0,0,0,1,0,496,0,5,501,0
16,285,73,28,4,1,0,0,1,0,0,1,0,0,393,0,12,405,0
17,283,97,20,2,1,0,0,0,0,0,0,0,0,403,0,5,408,0
18,245,152,16,14,0,0,0,0,0,0,0,1,0,428,0,5,433,0
19,303,101,22,4,0,0,0,0,0,0,0,2,0,432,0,12,444,0
20,204,54,13,2,0,0,0,0,0,0,0,0,0,273,0,7,280,0
21,426,81,26,8,0,0,1,0,1,0,1,1,0,545,0,7,552,0
22,301,78,15,5,0,0,0,0,0,0,1,0,0,400,0,6,406,0
23,360,95,16,8,1,0,0,0,0,0,0,0,0,480,0,9,489,0
24,332,51,7,3,0,1,0,0,0,0,0,1,0,395,0,9,404,0
25,336,72,25,1,0,1,0,0,0,1,0,0,0,436,0,8,444,0
26,337,118,26,18,1,1,1,0,0,0,0,1,0,503,0,5,508,0
27,409,50,15,3,0,0,0,0,0,0,1,0,2,480,0,12,492,0
28,133,198,7,26,0,1,0,0,0,0,0,1,1,367,0,3,370,0
29,310,142,18,36,0,0,0,1,0,0,1,0,2,510,0,9,519,0
30,308,189,11,52,0,0,0,0,0,0,0,1,1,562,0,6,568,0
31,224,181,15,25,0,2,1,0,1,0,1,1,1,452,0,9,461,0
32,256,130,21,50,0,0,1,0,2,0,1,0,3,464,0,4,468,0
33,327,63,12,6,1,0,1,1,0,1,0,0,1,413,0,0,413,0
34,160,143,18,33,0,2,0,0,0,0,0,0,0,356,0,7,363,0
35,46,436,38,8,0,0,0,1,0,0,0,2,9,540,0,5,545,0
36,28,440,28,9,1,0,0,0,0,0,1,0,0,507,0,1,508,0
37,21,198,29,14,2,0,0,0,0,1,0,0,3,268,0,3,271,0
38,17,515,32,13,2,0,0,0,0,0,0,0,4,583,0,1,584,0
39,12,395,18,7,1,0,1,0,0,1,0,1,4,440,0,5,445,0
40,10,374,9,4,0,0,0,1,0,0,0,0,2,400,0,2,402,0
41,84,414,19,0,1,1,1,0,0,0,0,1,1,522,0,11,533,0
42,133,325,33,11,0,0,0,0,0,1,0,1,2,506,0,4,510,0
43,99,336,30,11,1,0,0,1,0,0,0,1,0,479,0,1,480,0
44,40,337,18,8,0,0,1,0,1,0,0,1,2,408,0,4,412,0
45,8,232,       ?     4,2,2,0,0,0,0,0,0,1,1,250,0,2,252,0
46,20,769,43,15,2,1,0,1,1,0,0,6,11,869,0,6,875,0
47,37,467,36,8,1,1,0,0,0,0,1,0,5,556,0,5,561,0
48,15,719,30,14,0,1,0,1,1,1,1,1,2,786,0,3,789,0
49,25,633,50,11,1,0,0,0,0,0,0,4,4,728,0,8,736,0
50,17,465,46,6,1,0,0,0,0,0,1,1,3,540,0,5,545,0
51,19,499,42,16,3,1,0,0,0,0,1,0,3,584,0,1,585,0
52,11,446,35,11,0,0,1,0,0,0,0,1,2,507,0,0,507,0
53,18,463,32,8,0,0,0,0,0,0,3,2,2,528,0,5,533,0
54,40,524,23,11,0,0,0,1,1,1,1,2,4,608,0,6,614,0
55,41,669,34,8,2,0,1,0,0,0,1,4,7,767,0,4,771,0
56,41,442,26,3,3,0,1,0,0,1,0,4,8,529,0,2,531,0
57,9,670,38,14,1,0,1,0,1,1,1,3,4,743,0,7,750,0
58,12,553,30,7,0,0,0,1,1,0,2,1,3,610,0,1,611,0
59,47,596,31,19,0,0,0,1,0,2,0,0,6,702,0,5,707,0
60,10,384,17,9,0,0,0,0,0,1,0,2,4,427,0,1,428,0
61,20,484,27,10,0,0,0,0,0,0,0,1,0,542,0,1,543,0
62,205,187,21,8,1,1,0,1,0,2,0,0,1,427,0,6,433,0
63,57,577,40,8,2,0,0,1,0,0,0,2,6,693,0,7,700,0
64,17,562,33,18,4,1,0,1,0,1,1,1,7,646,0,6,652,0
65,14,347,30,6,0,3,0,0,0,1,0,1,2,404,0,1,405,0
66,8,393,30,10,0,0,0,0,0,0,0,0,3,444,0,4,448,0
67,10,449,54,6,2,2,0,0,0,1,1,1,6,532,0,0,532,0
68,12,592,43,13,2,0,0,0,0,0,0,4,8,674,0,5,679,0
69,22,429,31,14,0,0,0,0,0,1,0,2,2,501,0,0,501,0
70,60,644,37,9,2,1,0,0,0,0,2,2,2,759,0,7,766,0
71,24,462,36,12,1,0,1,0,0,1,0,2,3,542,0,2,544,0
72,40,630,51,10,1,1,0,1,1,0,3,2,7,747,0,4,751,0
73,17,340,32,13,1,0,0,0,0,0,0,0,1,404,0,0,404,0
74,25,327,40,14,2,0,0,1,1,2,1,1,1,415,0,11,426,0
75,12,407,21,18,2,0,1,0,0,1,1,3,3,469,0,2,471,0
76,14,372,14,17,0,0,1,0,0,0,1,1,2,422,0,0,422,0
77,307,39,7,6,1,0,0,0,0,0,0,0,0,360,0,4,364,0
78,106,43,5,3,1,0,0,0,0,2,0,0,0,160,0,1,161,0
79,125,78,7,7,0,0,0,1,0,1,0,1,0,220,0,1,221,0
80,309,48,5,2,0,0,1,1,0,0,0,0,3,369,0,2,371,0
81,240,70,3,6,0,0,0,0,0,0,1,0,0,320,0,2,322,0
82,328,75,15,16,0,0,0,0,0,0,0,1,0,435,0,6,441,0
83,234,427,31,43,0,1,0,0,0,0,2,3,8,749,0,5,754,0
84,342,187,27,22,1,0,1,0,1,0,0,0,7,588,0,5,593,0
85,201,91,6,29,2,0,0,0,1,0,0,0,2,332,0,4,336,0
86,226,104,6,30,0,0,0,0,1,1,0,0,2,370,0,3,373,0
87,228,108,10,21,2,0,0,0,0,0,0,0,0,369,0,4,373,0
88,383,67,17,12,0,0,1,0,1,0,0,0,1,482,0,11,493,0
89,300,61,8,8,0,1,0,0,0,1,1,0,2,382,0,4,386,0
90,328,80,23,14,0,0,0,0,0,0,2,0,0,447,0,4,451,0
91,418,158,22,12,1,0,0,0,0,1,0,0,0,612,0,5,617,0
92,177,248,12,106,1,0,2,1,0,0,1,0,2,550,0,5,555,0
93,238,192,15,54,1,0,0,1,0,1,0,1,2,505,0,5,510,0
94,135,71,0,24,0,0,0,0,0,1,0,1,1,233,0,1,234,0
95,198,40,12,3,1,0,0,0,0,0,0,0,1,255,0,2,257,0
96,437,216,27,32,1,2,0,1,1,4,2,6,10,739,0,24,763,0
97,252,186,16,36,3,5,3,4,3,5,6,6,5,530,0,6,536,0
98,373,254,13,52,2,0,2,1,1,0,2,0,2,702,0,7,709,0
99,347,261,8,31,1,0,1,0,1,0,0,1,2,653,0,6,659,0
100,306,351,34,64,2,0,0,0,0,1,1,0,3,762,0,7,769,0
101,234,213,16,17,2,0,0,1,0,0,0,1,5,489,0,5,494,0
102,222,142,23,29,0,2,0,1,1,2,0,1,0,423,0,10,433,0
103,386,63,32,7,0,0,0,0,0,1,2,0,0,491,0,17,508,0
104,492,146,19,23,0,0,0,0,1,1,0,0,2,684,0,10,694,0
105,275,38,14,2,0,0,0,0,0,0,0,0,0,329,0,5,334,0
106,206,66,10,10,0,0,0,0,0,1,0,0,0,293,0,7,300,0
107,249,36,17,10,0,0,0,0,0,0,0,0,0,312,0,6,318,0
108,308,245,28,21,0,2,2,0,1,0,0,2,3,612,0,7,619,0
109,133,146,17,14,2,1,0,1,0,0,1,0,0,315,0,3,318,0
110,206,344,23,30,2,0,2,1,2,2,3,2,5,622,0,5,627,0
111,433,128,17,7,1,0,0,             X,0,0,0,0,0,587,0,3,590,0
112,221,251,28,18,1,1,0,0,1,0,0,0,1,522,0,5,527,0
113,197,197,27,47,0,1,1,0,1,0,1,1,0,473,0,8,481,0
114,230,230,32,67,2,0,1,0,0,1,0,0,1,564,0,5,569,0
115,323,91,27,26,0,0,1,1,0,0,1,0,0,470,0,14,484,0
116,178,84,12,19,0,0,1,0,0,1,1,0,1,297,0,8,305,0
117,254,148,15,26,1,0,0,0,0,0,1,0,0,445,0,3,448,0
118,452,207,19,32,0,1,2,1,0,2,2,1,1,720,0,18,738,0
119,183,188,19,73,2,1,3,0,0,1,3,2,5,480,0,3,483,0
120,303,150,15,23,2,1,1,1,0,2,3,3,3,507,0,5,512,0
121,297,190,16,59,3,2,1,0,0,0,1,2,4,575,0,19,594,0
122,334,243,19,50,0,0,1,0,1,1,2,2,4,657,0,8,665,0
123,373,284,18,42,2,1,2,0,0,0,2,2,6,732,0,8,740,0
124,252,303,23,79,2,1,0,0,0,0,1,2,1,664,0,8,672,0
125,225,265,31,98,1,3,1,0,0,0,1,2,1,628,0,18,646,0
126,223,304,31,42,0,0,1,0,1,0,0,0,0,602,0,15,617,0
127,307,235,15,84,2,1,0,0,0,0,0,1,0,645,0,10,655,0
128,411,141,14,23,2,0,4,0,1,1,1,3,1,602,0,7,609,0
129,244,170,12,24,0,1,3,0,0,1,0,0,0,455,0,4,459,0
130,168,115,18,31,2,0,0,0,0,0,0,0,1,335,0,6,341,0
131,177,88,13,44,0,2,2,0,0,0,0,1,0,327,0,5,332,0
132,194,93,5,15,0,2,1,1,0,0,0,0,2,313,0,3,316,0
133,190,202,7,14,0,0,0,0,0,0,1,1,0,415,0,2,417,0
134,271,220,15,34,0,0,0,0,0,0,0,1,3,544,0,7,551,0
135,264,221,15,51,1,0,1,1,0,0,0,2,3,559,0,5,564,0
136,183,185,18,53,1,0,1,1,0,1,1,0,1,445,0,5,450,0
137,265,222,15,80,1,0,0,0,1,1,1,1,3,590,0,10,600,0
138,264,257,23,53,0,1,0,0,1,0,0,0,4,603,0,11,614,0
139,113,168,17,42,0,1,0,1,1,0,0,1,0,344,0,6,350,0
140,161,113,5,36,1,0,0,0,0,0,1,0,0,317,0,9,326,0
141,316,327,14,50,1,0,0,0,0,1,0,1,1,711,0,7,718,0
142,305,169,15,49,1,2,0,0,0,0,0,2,2,545,0,11,556,0
143,119,129,7,25,0,2,0,0,0,0,0,2,0,284,0,5,289,0
144,309,239,17,58,0,0,0,0,0,1,1,1,0,626,0,15,641,0
145,160,140,13,44,1,3,1,1,1,1,0,1,1,367,0,10,377,0
146,133,230,18,47,              2   ?,0,0,2,0,0,1,0,1,434,0,10,444,0
147,192,92,7,13,0,1,1,1,0,1,1,0,0,309,0,6,315,0
148,345,99,21,14,0,0,0,0,1,1,0,0,1,482,0,2,484,0
149,369,123,12,12,0,0,0,0,1,0,2,2,0,521,0,8,529,0
150,335,81,12,10,0,0,0,0,0,0,2,0,0,440,0,7,447,0
151,272,62,12,7,0,1,0,0,0,0,0,0,0,354,0,5,359,0
152,447,112,13,29,1,4,1,0,0,0,0,0,0,607,0,7,614,0
153,368,154,13,25,0,0,0,0,0,0,4,0,0,564,0,7,571,0
154,303,67,7,15,0,0,0,0,0,0,1,0,1,394,0,3,397,0
155,346,148,9,20,1,0,0,0,1,1,1,1,0,528,0,6,534,0
156,324,107,11,6,0,1,1,0,0,0,0,0,0,450,0,1,451,0
157,311,81,14,14,        ?   0,0,0,1,0,0,0,0,0,421,0,4,425,0
158,255,116,14,17,1,0,0,0,0,0,0,1,0,404,0,6,410,0
159,335,139,13,9,0,1,0,1,0,1,1,0,0,500,0,14,514,0
160,271,63,19,7,0,0,0,0,0,0,0,0,0,360,0,7,367,0
161,363,134,18,29,2,2,0,0,0,0,0,0,1,549,0,14,563,0
162,269,105,6,37,0,3,1,1,0,0,0,0,1,423,0,4,427,0
163,221,148,6,38,1,1,0,0,0,1,0,0,0,416,0,11,427,0
164,241,145,17,14,0,2,0,0,0,0,0,0,1,420,0,4,424,0
165,292,158,13,39,0,0,1,0,0,0,0,0,2,505,0,4,509,0
166,360,127,7,7,0,0,0,1,0,1,0,0,0,503,0,7,510,0
167,274,196,15,36,1,4,0,0,0,0,0,0,0,526,0,4,530,0
168,282,177,8,35,1,0,0,0,0,0,0,0,2,505,0,10,515,0
169,332,98,5,15,0,0,1,0,1,0,0,1,1,454,0,3,457,0
170,319,179,16,22,0,0,0,1,0,1,0,0,0,538,0,3,541,0
171,318,189,8,43,0,2,0,0,0,0,1,1,2,564,0,7,571,0
172,280,123,17,39,1,1,0,0,0,0,0,1,1,463,0,6,469,0
173,241,82,7,10,0,0,2,0,0,0,0,0,2,344,0,4,348,0
174,171,86,6,20,1,1,0,0,0,0,1,1,1,288,0,5,293,0
175,342,112,13,31,0,3,0,0,0,0,1,0,2,504,0,11,515,0
176,273,136,11,27,1,0,0,0,0,0,1,0,1,450,0,10,460,0
177,233,183,13,62,0,1,1,1,0,0,0,0,1,495,0,5,500,0
178,120,33,6,4,0,1,0,0,0,0,0,0,1,165,0,6,171,0
179,266,184,15,30,2,1,1,0,1,1,1,1,2,505,0,5,510,0
180,208,211,13,43,0,0,0,0,0,0,0,0,0,475,0,8,483,0
181,153,109,7,25,0,1,0,0,0,0,0,2,0,297,0,6,303,0
182,333,220,17,50,1,0,1,0,0,2,0,0,6,630,0,12,642,0
183,284,264,8,40,0,0,1,1,0,2,0,1,4,605,0,11,616,0
184,258,129,17,30,1,0,2,1,0,1,0,3,1,443,0,17,460,0
185,137,119,6,39,0,1,0,1,0,1,0,0,0,304,0,3,307,0
186,163,119,13,22,0,3,0,0,0,0,0,0,1,321,0,8,329,0
187,251,156,6,39,1,2,0,1,0,0,0,1,0,457,0,7,464,0
188,202,128,11,9,1,1,0,0,0,0,0,0,1,353,0,7,360,0
189,219,72,16,26,0,2,0,0,1,0,0,1,0,337,0,5,342,0
190,200,208,13,65,1,0,2,0,0,0,1,1,1,492,0,6,498,0
191,245,157,10,26,1,1,0,0,1,1,1,1,0,444,0,12,456,0
192,191,161,7,29,0,0,2,0,0,0,2,0,0,392,0,3,395,0
193,298,187,10,48,0,9,1,0,0,0,1,2,0,556,0,11,567,0
194,202,166,18,60,0,2,0,0,0,1,0,1,5,455,0,6,461,0
195,243,122,16,40,1,0,0,0,0,1,0,1,0,424,0,9,433,0
196,127,142,24,37,0,1,0,1,0,0,0,0,0,332,0,11,343,0
197,182,146,12,28,0,3,0,0,0,0,0,1,1,373,0,10,383,0
198,185,120,13,42,0,2,0,0,0,0,0,0,1,363,0,15,378,0
199,208,162,9,47,0,4,0,0,0,1,0,0,2,433,0,5,438,0
200,269,270,8,27,1,0,0,1,0,1,1,2,1,581,0,3,584,0
201,126,53,11,24,0,0,0,0,2,1,0,0,0,217,0,5,222,0
202,289,185,19,59,0,1,2,0,1,2,0,1,1,560,0,16,576,0
203,378,189,22,26,0,3,0,2,1,0,1,3,4,629,0,13,642,0
204,246,152,6,12,1,0,0,0,0,0,0,0,0,417,0,3,420,0
205,310,156,10,30,4,2,0,0,0,1,0,1,2,516,0,13,529,0
206,280,179,10,25,0,0,0,0,0,0,0,0,3,497,0,7,504,0
207,346,249,17,51,0,4,1,1,0,1,1,2,1,674,0,9,683,0
208,169,190,5,34,1,2,0,0,0,0,0,0,1,402,0,4,406,0
209,174,203,7,13,1,1,1,0,1,1,0,2,5,409,0,3,412,0
210,97,63,7,15,1,1,0,0,0,0,0,0,0,184,0,4,188,0
211,260,214,8,74,0,3,2,1,0,1,0,1,1,565,0,15,580,0
212,129,156,16,29,0,0,1,0,0,1,0,2,1,335,0,8,343,0
213,290,269,20,62,0,2,1,1,0,1,1,2,1,650,0,12,662,0
214,241,297,14,71,0,2,2,0,0,0,1,4,9,641,0,2,643,0
215,191,243,15,43,0,4,1,1,1,2,3,3,2,509,0,16,525,0
216,194,226,15,74,0,2,0,0,0,1,1,1,0,514,0,10,524,0
217,229,282,18,36,1,0,1,0,0,1,3,0,3,574,0,7,581,0
218,237,225,22,58,0,1,0,0,0,0,0,2,0,545,0,11,556,0
219,360,389,16,74,5,4,3,2,1,5,1,2,3,865,0,8,873,0
220,172,325,21,70,4,0,0,1,0,1,0,0,0,594,0,10,604,0
221,287,203,7,47,2,1,1,1,0,0,2,0,0,551,0,6,557,0
222,226,348,16,80,1,1,1,1,0,0,0,1,1,676,0,9,685,0
223,214,278,13,112,0,0,1,0,0,0,0,1,0,619,0,7,626,0
224,196,292,12,54,1,1,0,1,0,1,0,1,1,560,0,5,565,0
225,234,230,8,62,1,2,0,2,1,2,0,1,1,544,0,8,552,0
226,249,154,13,46,0,1,0,0,0,1,0,0,2,466,0,11,477,0
227,358,163,18,30,0,0,0,0,1,1,0,0,1,572,0,9,581,0
228,385,149,11,20,11,2,0,0,0,2,3,5,4,592,0,10,602,0
229,217,89,2,13,4,1,1,0,0,2,0,1,3,333,0,4,337,0
230,188,274,20,37,2,0,0,0,0,0,0,0,0,521,0,9,530,0
231,180,120,18,44,0,0,0,0,1,0,0,1,0,364,0,11,375,0
232,269,195,21,73,1,3,0,0,0,0,0,0,0,562,0,5,567,0
233,306,312,16,46,3,1,2,2,0,3,5,4,18,718,0,10,728,0
234,259,297,8,43,2,2,3,1,0,3,0,1,4,623,0,7,630,0
235,95,191,7,23,0,0,0,0,0,0,1,1,2,320,0,3,323,0
236,248,306,12,68,1,4,1,2,0,1,0,1,2,646,0,9,655,0
237,334,245,13,42,3,0,1,1,0,0,1,2,1,643,0,4,647,0
238,235,238,13,69,1,2,1,1,0,1,1,1,1,564,0,9,573,0
239,347,389,19,64,0,7,2,0,0,0,1,1,1,831,0,7,838,0
240,124,160,10,48,1,0,0,0,0,0,0,0,1,344,0,5,349,0
241,199,203,12,60,2,0,0,0,0,0,1,4,1,482,0,1,483,0
242,208,221,2,63,3,0,0,0,0,1,0,3,,504,0,5,509,0
243,237,287,9,70,2,0,3,0,1,1,0,2,1,613,0,4,617,0
244,157,206,8,55,0,0,3,0,0,0,1,4,1,435,0,2,437,0
245,268,314,21,92,2,2,2,0,0,2,2,1,1,707,0,16,723,0
246,207,161,9,61,2,0,0,0,0,0,1,1,0,442,0,7,449,0
247,286,241,25,85,3,1,2,0,0,0,2,0,2,647,0,10,657,0
248,172,179,14,65,0,1,0,0,0,0,1,0,1,433,0,8,441,0
249,196,198,10,75,4,1,3,0,0,1,1,5,2,496,0,3,499,0
250,172,337,13,102,1,0,1,0,1,0,1,0,2,630,0,10,640,0
251,149,252,20,94,1,3,1,2,0,0,0,0,0,522,0,11,533,0
252,213,356,24,79,1,1,0,2,0,0,1,1,4,682,0,7,689,0
253,176,228,5,46,1,0,0,1,0,0,1,1,3,462,0,6,468,0
254,369,362,12,64,1,0,1,1,1,2,4,3,3,823,0,7,830,0
255,174,302,18,112,0,1,2,0,0,1,1,0,1,612,0,14,626,0
256,200,176,9,50,1,0,0,0,0,0,0,0,1,437,0,6,443,0
257,315,347,13,92,3,1,2,1,1,0,1,4,1,781,0,6,787,0
258,223,334,17,82,0,2,0,0,0,0,0,0,0,658,0,13,671,0
259,271,299,17,70,2,2,1,0,0,1,1,1,3,668,0,11,679,0
260,126,193,18,88,0,0,0,1,0,0,0,3,0,429,0,10,439,0
261,160,210,20,127,0,0,1,0,0,0,2,1,1,522,0,17,539,0
262,238,275,14,88,2,1,2,0,0,0,0,1,1,622,0,8,630,0
263,253,232,12,53,1,2,2,2,0,0,2,2,6,567,0,9,576,0
264,323,375,11,51,2,1,1,0,0,2,0,5,6,777,0,5,782,0
265,230,397,28,65,3,1,1,1,0,1,0,0,6,733,0,19,752,0
266,271,321,22,87,5,3,3,1,0,0,3,3,1,720,0,15,735,0
267,340,471,20,23,2,8,2,2,3,2,4,10,8,895,0,5,900,0
268,122,65,4,1,0,1,0,0,0,0,0,2,0,195,0,3,198,0
269,439,453,14,49,2,17,3,1,0,4,2,7,10,1001,0,5,1006,0
1,2,3,4,5,6,7,8,9,10,11,12,13,14,15,16,17,18,19
29,248,128,12,39,0,1,0,2,1,0,1,0,2,434,0,9,443,0
30,289,109,41,47,0,1,0,0,0,0,1,0,0,488,0,11,499,0
31,332,341,10,49,1,2,2,1,0,3,3,3,6,753,0,11,764,0
32,298,283,16,33,1,1,3,0,5,5,0,8,10,663,0,16,679,0
33,273,263,14,61,0,0,1,0,1,1,0,3,6,623,0,4,627,0
34,120,190,11,19,0,2,0,0,0,0,2,1,9,354,0,3,357,0
35,150,180,18,28,1,4,1,1,0,0,0,0,4,387,0,2,389,0
36,149,284,34,51,2,2,0,0,0,2,0,2,7,533,0,11,544,0
37,91,147,8,18,0,0,0,0,0,2,0,2,1,269,0,3,272,0
38,376,268,9,30,2,2,0,2,0,2,3,4,9,707,0,10,717,0
39,133,102,3,19,0,0,2,0,0,1,2,0,2,264,0,4,268,0
40,294,328,13,48,5,1,3,2,0,1,1,5,6,707,0,12,719,0
41,235,258,19,36,0,3,0,0,0,0,3,2,2,558,0,12,570,0
42,89,115,13,42,1,0,0,0,0,0,0,1,0,261,0,4,265,0
43,138,119,11,81,1,1,0,0,0,0,0,1,1,353,0,11,364,0
44,108,143,15,62,3,0,0,0,0,0,0,0,0,331,0,7,338,0
45,385,170,8,51,0,0,0,0,1,1,0,0,3,619,0,5,624,0
46,250,195,18,52,0,2,3,0,1,1,0,2,5,529,0,5,534,0
47,272,474,22,70,1,5,3,0,1,0,2,3,3,856,0,4,860,0
48,190,180,13,44,2,2,1,0,2,0,0,1,2,437,0,4,441,0
49,148,185,21,41,0,0,0,0,0,0,0,0,0,395,0,3,398,0
50,279,314,46,52,1,0,1,0,1,0,1,2,2,699,0,5,704,0
51,96,109,13,47,1,0,0,1,0,0,0,0,0,267,0,5,272,0
52,298,282,32,43,1,0,0,0,0,1,0,2,0,659,0,5,664,0
53,326,232,23,58,1,2,1,1,0,1,2,1,4,652,0,4,656,0
54,118,218,30,107,1,1,2,2,1,0,1,2,2,485,0,4,489,0
55,167,205,10,98,0,1,1,0,0,0,0,2,0,484,0,6,490,0
56,115,175,13,103,5,1,0,0,1,0,0,0,1,414,0,1,415,0
57,113,265,33,91,0,0,0,0,0,0,0,0,1,503,0,9,512,0
58,131,207,22,49,0,0,0,0,0,0,1,0,0,410,0,9,419,0
59,173,298,20,60,0,3,3,0,0,0,0,0,2,559,0,7,566,0
60,205,381,25,80,1,0,1,0,2,1,1,2,7,706,0,13,719,0
61,148,286,19,69,0,1,2,1,0,1,1,1,1,530,0,3,533,0
62,281,388,29,108,2,3,3,2,0,5,1,4,6,832,0,7,839,0
63,119,116,6,45,0,1,1,0,0,1,0,0,2,291,0,4,295,0
                                 ()4,143,252,7,68,1,3,2,1,0,0,1,1,4,483,0,7,490,0
65,60,160,14,98,0,1,1,1,0,0,0,1,1,337,0,13,350,0
66,148,274,20,151,2,0,3,1,0,0,2,0,1,602,0,11,613,0
67,90,126,4,28,0,0,1,0,0,0,0,0,0,249,0,4,253,0
                                 (Â»Â«,100,151,10,49,0,0,0,0,0,0,0,0,0,310,0,5,315,0
69,135,155,19,77,2,0,0,0,0,0,1,1,0,390,0,10,400,0
70,248,167,17,33,0,1,0,0,0,0,1,1,0,468,0,9,477,0
71,246,324,11,120,3,1,4,0,0,0,4,5,4,722,0,9,731,0
72,138,166,10,53,0,1,0,"                                  , 0",0,0,0,0,1,369,0,6,375,0
73,222,326,13,71,1,1,1,0,0,4,0,2,3,644,0,6,650,0
74,167,264,7,93,0,3,2,1,0,3,1,4,5,550,0,4,554,0
75,165,162,9,40,2,3,2,0,1,0,3,3,0,390,0,3,393,0
76,373,165,13,24,3,0,2,1,1,2,0,3,0,587,0,12,599,0
77,190,108,12,56,0,1,1,1,2,0,0,0,1,372,0,1,373,0
78,115,174,11,46,1,1,2,0,0,2,2,1,2,357,0,3,360,0
79,144,309,21,70,2,0,0,1,1,3,1,4,4,560,0,4,564,0
80,226,298,17,112,2,2,4,1,0,1,1,2,5,671,0,8,679,0
81,159,285,16,117,0,0,0,0,1,0,2,1,2,583,0,5,588,0
82,94,194,12,44,1,0,2,0,0,0,0,0,1,348,0,7,355,0
83,142,229,6,78,0,1,0,2,0,0,2,1,1,462,0,6,468,0
84,194,200,21,110,2,1,0,2,0,0,0,0,0,530,0,13,543,0
85,124,244,16,31,4,1,0,0,0,3,0,1,3,427,0,7,434,0
86,287,329,20,57,4,4,1,3,0,0,2,3,1,711,0,11,722,0
87,144,281,25,23,2,2,1,3,3,3,2,3,13,505,0,3,508,0
88,346,294,17,47,1,1,1,0,2,1,5,3,6,724,0,8,732,0
89,221,209,9,24,2,1,0,0,0,1,1,2,2,472,0,10,482,0
90,167,209,13,69,1,0,1,0,1,0,2,0,3,466,0,8,474,0
91,149,187,15,47,0,3,1,0,0,1,0,2,2,407,0,6,413,0
92,156,279,15,74,1,7,0,1,0,0,0,3,0,536,0,7,543,0
93,13,153,8,26,0,3,0,1,0,1,0,1,1,237,0,3,240,0
                                                 9S,190,183,17,75,1,4,0,0,1,0,1,0,0,472,0,14,486,0
                                                 9(),156,245,19,88,0,3,0,1,0,1,1,0,0,514,0,15,529,0
97,246,284,14,84,1,1,2,0,0,0,1,0,1,634,0,9,643,0
98,193,158,6,70,2,0,0,0,1,0,1,0,0,431,0,8,439,0
99,161,239,21,124,0,12,1,1,1,0,1,0,1,562,0,11,573,0
100,157,306,20,109,2,10,1,1,0,0,1,0,0,607,0,8,615,0
101,277,236,16,84,1,0,0,1,0,0,1,0,0,616,0,14,630,0
102,294,229,16,55,1,1,2,1,2,2,2,3,3,611,0,12,623,0
103,207,275,19,87,0,3,0,0,0,0,2,2,3,598,                                                     G,24,622,0
104,191,293,16,117,0,3,0,1,1,0,0,0,0,622,0,9,631,0
105,210,258,22,148,1,5,1,0,0,0,2,1,0,648,0,15,663,0
106,276,286,14,40,0,0,0,0,1,0,3,5,6,631,0,5,636,0
107,158,144,11,26,2,0,0,0,1,0,1,1,7,351,0,4,355,0
108,297,188,18,48,0,0,0,0,0,1,1,3,3,559,0,3,562,0
109,286,240,16,64,2,2,0,0,0,2,1,3,5,621,0,13,634,0
110,278,270,10,34,3,1,0,0,0,0,1,1,7,605,0,6,611,0
111,171,188,10,31,0,"                                                   ,  1",0,0,0,0,1,2,5,409,0,9,418,0
112,140,90,11,35,0,2,0,0,0,0,0,1,0,279,0,6,285,0
141,186,102,18,58,0,0,1,0,0,0,0,0,0,365,0,6,371,0
142,204,128,20,44,0,1,0,1,0,0,1,0,0,399,0,8,407,0
143,184,99,17,30,0,0,0,0,0,1,0,0,0,331,0,16,347,0
144,275,144,14,20,0,0,0,0,0,0,1,0,2,456,0,10,466,0
145,292,126,25,47,0,1,1,0,0,0,3,0,1,496,0,13,509,0
146,165,                                                        221   .,4,29,1,0,0,0,0,0,0,1,2,423,0,4,427,0
                                                      M7,231,247,10,90,1,1,0,1,0,3,1,0,1,586,0,10,596,0
,243,263,27,48,0,2,1,1,0,0,0,2,1,588,0,10,598,0
152,95,85,9,11,0,1,0,0,0,0,0,0,1,202,0,2,204,0
153,160,141,10,42,0,0,1,0,0,0,1,0,0,355,0,7,362,0
154,127,123,3,47,0,1,0,1,0,0,0,2,1,305,0,3,308,0
155,168,172,15,38,1,2,0,0,2,0,0,0,0,398,0,8,406,0
156,250,305,22,109,1,6,0,0,0,2,0,3,1,699,0,17,716,0
157,101,88,10,35,0,1,0,0,0,0,0,1,0,236,0,2,238,0
158,134,140,9,60,0,0,1,1,0,0,0,0,0,345,0,15,360,0
159,220,319,5,59,0,1,0,1,0,1,1,1,3,611,0,3,614,0
160,93,76,15,46,2,1,0,,0,0,0,0,0,233,0,9,242,0
161,                                                     .  148,146,7,19,0,2,0,1,0,0,0,1,1,325,0,7,332,0
162,255,140,15,57,0,1,0,1,0,1,1,0,0,471,0,14,485,0
163,118,44,12,16,0,0,0,,0,0,0,0,0,190,0,3,193,0
164,193,308,5,25,2,2,0,1,1,2,3,0,1,543,0,5,548,0
165,271,286,5,21,0,2,0,1,1,1,0,0,0,588,0,2,590,0
166,326,436,10,64,1,1,2,2,0,3,2,6,3,856,0,6,862,0
167,100,222,13,42,1,2,0,0,0,0,1,1,0,382,0,5,387,0
168,199,260,3,16,1,0,0,1,1,0,0,3,1,485,0,8,493,0
197,95,100,9,65,0,1,0,0,0,0,0,1,0,271,0,5,276,0
198,360,314,12,77,2,1,0,1,1,1,2,1,4,776,0,3,779,0
199,236,244,16,92,2,1,0,0,0,0,0,2,0,593,0,6,599,0
200,256,244,13,86,0,2,1,0,0,0,1,1,2,606,0,6,612,0
201,154,215,54,44,3,0,1,1,0,1,2,2,10,487,0,8,495,0
302,207,222,21,50,0,1,0,0,0,2,1,2,2,508,0,7,515,0
                                   ?03,267,228,22,44,2,0,0,1,0,1,1,0,3,569,0,8,577,0
,148,236,22,51,1,1,0,0,0,0,0,0,0,659,0,15,674,0
                                          ?()'),73,234,8,84,0,2,1,0,0,0,0,0,0,382,0,7,389,0
                                   ;o/,344,253,26,89,2,6,2,1,2,0,1,4,2,732,0,11,743,0
,243,                                                       IHO,19,41,1,1,0,0,1,0,0,0,0,486,0,16,502,0
210,254,197,27,92,0,0,0,0,0,0,0,0,3,573,0,17,590,0
211,138,306,29,58,2,1,0,0,0,0,0,0,0,534,0,2,536,0
212,27,264,20,71,0,0,0,0,0,0,0,0,1,383,0,1,384,0
213,61,236,11,79,1,0,0,0,0,2,1,1,0,392,0,0,392,0
214,320,237,10,74,1,3,3,1,0,2,0,2,5,658,0,9,667,0
215,312,297,18,33,1,1,3,0,1,3,3,2,3,677,0,5,682,0
216,275,272,33,49,0,1,0,1,0,1,1,1,3,637,0,                                     S,645,0
217,273,131,19,48,1,0,1,1,0,1,1,0,0,476,0,15,491,0
218,214,129,21,58,1,0,0,3,0,0,0,0,1,427,0,6,433,0
219,251,241,17,112,2,2,1,1,1,1,0,1,3,633,0,9,642,0
220,254,236,12,82,2,0,1,0,0,0,4,5,4,600,0,5,605,0
221,146,108,12,41,0,1,0,1,0,0,3,0,1,313,0,7,320,0
222,144,69,15,56,1,0,0,0,0,0,0,0,0,285,0,5,290,0
223,132,106,22,40,0,0,1,0,0,1,0,0,0,302,0,10,312,0
224,157,104,18,70,0,0,0,0,0,0,0,0,0,349,0,9,358,0
244,204,193,15,39,1,0,1,0,0,0,1,1,2,457,0,2,459,0
245,261,202,9,153,0,3,2,1,0,0,2,2,1,636,0,5,641,0
246,104,107,7,67,1,1,1,0,0,1,3,0,1,293,0,4,297,0
247,211,208,17,102,0,2,1,0,0,1,0,1,1,544,0,9,553,0
248,127,84,14,40,0,0,0,0,1,0,0,0,0,266,0,3,269,0
249,185,133,12,75,0,0,1,1,1,0,4,0,0,412,0,8,420,0
                                                 7 SO,257,117,7,47,3,0,0,0,1,0,1,1,1,435,0,5,440,0
259,170,122,19,44,0,0,0,0,0,0,0,0,1,356,0,6,362,0
260,211,126,15,69,1,0,0,1,2,0,0,0,0,425,0,18,443,0
261,478,119,49,55,0,1,0,0,0,0,4,1,1,708,0,16,724,0
262,71,157,14,147,0,0,1,0,0,0,0,1,1,392,0,4,396,0
263,239,191,17,141,0,0,0,0,0,0,0,0,0,588,0,8,596,0
264,                                               ?   291,162,11,55,0,0,1,0,1,2,1,0,2,526,0,9,535,0
265,151,276,15,95,1,2,0,1,0,0,0,0,0,541,0,6,547,0
266,144,105,8,74,0,1,2,0,0,0,0,1,0,335,0,16,351,0
267,205,397,18,181,1,0,0,0,0,0,0,2,1,805,0,10,815,0
268,190,180,13,129,3,4,1,1,1,0,0,0,0,522,0,7,529,0
269,152,152,8,146,1,2,0,0,1,1,0,1,1,465,0,10,475,0
270,201,248,9,177,0,0,3,0,0,0,0,1,1,640,0,7,647,0
1,139,210,18,24,0,0,0,0,0,0,2,0,1,394,0,5,399,0
2,193,152,8,32,0,0,1,1,1,0,1,1,2,392,0,1,393,0
3,134,231,34,41,0,0,0,1,0,0,0,0,0,441,0,6,447,0
4,84,582,20,14,1,0,0,0,1,0,0,2,3,707,0,3,710,0
5,123,372,37,28,0,0,0,0,0,0,0,1,3,564,0,5,569,0
6,96,339,31,39,0,1,0,0,1,0,0,0,5,512,0,7,519,0
7,15,602,30,13,0,1,0,0,1,0,0,4,7,673,0,2,675,0
8,16,696,32,14,0,0,0,0,0,0,0,1,4,763,0,6,769,0
9,27,499,35,17,2,0,1,1,0,0,1,2,2,587,0,3,590,0
10,8,499,39,11,2,0,1,0,0,0,0,0,3,563,0,2,565,0
11,8,250,10,1,0,0,0,0,0,0,0,0,0,269,0,0,269,0
12,73,561,46,28,2,1,0,0,1,2,3,2,2,721,0,7,728,0
13,17,490,35,45,1,1,0,0,0,0,0,1,1,591,0,8,599,0
14,12,506,21,25,3,0,0,0,0,0,1,1,1,570,0,2,572,0
15,18,550,55,13,1,0,1,0,0,0,0,1,4,643,0,4,647,0
16,51,544,31,34,2,0,0,0,0,1,1,1,2,667,0,10,677,0
17,97,537,24,22,1,1,1,0,0,2,3,1,5,694,0,9,703,0
18,33,411,19,15,0,0,0,1,2,0,1,1,1,484,0,2,486,0
19,61,69,2,21,0,0,0,0,0,0,0,0,0,153,0,0,153,0
20,182,205,9,56,0,1,0,0,0,2,0,0,0,455,0,5,460,0
21,214,504,23,32,0,0,0,0,0,0,0,6,0,779,0,7,786,0
22,72,626,65,31,4,0,0,0,1,2,1,4,7,813,0,11,824,0
23,29,307,43,8,2,0,0,0,0,0,0,0,0,389,0,6,395,0
24,101,433,31,15,0,0,0,0,0,0,0,1,7,588,0,0,588,0
25,42,574,48,35,2,1,1,1,1,1,0,4,4,714,0,5,719,0
26,64,446,43,23,1,1,0,0,0,0,0,3,2,583,0,8,591,0
27,23,680,43,34,1,1,0,0,0,1,1,0,6,790,0,1,791,0
28,30,703,35,13,0,0,2,0,0,1,0,2,2,788,0,8,796,0
29,4,257,9,23,0,0,0,0,0,0,0,0,0,293,0,2,295,0
30,22,764,67,19,2,0,2,0,2,1,0,4,10,893,0,11,904,0
31,26,476,34,34,0,1,2,0,0,0,1,1,2,577,0,5,582,0
32,25,556,43,14,0,0,1,0,0,0,1,1,3,644,0,3,647,0
33,23,591,67,26,1,1,0,0,0,1,0,7,2,719,0,1,720,0
34,14,703,96,25,1,2,0,2,2,0,1,6,3,855,0,7,862,0
35,34,623,54,32,1,0,0,1,0,3,0,4,3,755,0,5,760,0
36,11,656,41,23,2,0,0,1,0,0,1,2,3,740,0,8,748,0
37,7,454,23,26,0,1,0,0,0,0,1,2,8,522,0,5,527,0
38,9,362,29,36,1,0,0,1,0,0,0,0,6,444,0,4,448,0
39,40,484,43,18,0,0,1,1,0,2,0,0,3,592,0,3,595,0
40,5,288,37,0,0,0,0,0,0,0,2,1,5,338,0,3,341,0
41,35,589,64,31,1,0,2,0,0,0,0,3,5,730,0,7,737,0
42,36,504,28,74,3,0,1,0,1,0,0,1,2,650,0,4,654,0
43,27,531,60,29,2,1,0,0,1,1,0,3,2,657,0,1,658,0
44,40,279,36,14,1,1,1,1,1,0,1,2,5,382,0,5,387,0
45,30,565,26,16,1,1,0,0,0,0,1,0,0,640,0,6,646,0
46,23,303,11,8,0,0,1,0,0,1,0,0,0,347,0,4,351,0
47,55,77,5,10,1,0,0,0,0,0,0,0,0,148,0,3,151,0
48,80,326,55,11,2,3,0,0,0,1,2,1,2,483,0,7,490,0
49,8,191,15,10,2,0,0,1,0,0,1,0,0,228,0,0,228,0
50,309,314,21,11,1,1,0,0,1,4,0,3,11,676,0,2,678,0
51,12,554,34,4,1,0,0,0,0,0,0,2,6,613,0,6,619,0
52,60,409,28,11,0,0,0,0,0,1,1,2,3,515,0,6,521,0
53,44,587,34,14,2,0,2,0,0,1,0,5,8,697,0,8,705,0
54,7,617,48,16,0,0,0,0,0,0,0,2,0,690,0,3,693,0
55,10,735,62,11,3,1,0,1,1,1,0,1,2,828,0,4,832,0
56,23,490,43,28,0,0,1,1,0,1,0,2,0,589,0,0,589,0
57,11,275,57,8,0,0,0,0,0,0,0,0,0,351,0,3,354,0
58,3,296,97,6,0,0,0,0,0,0,0,0,1,403,0,2,405,0
59,20,450,98,16,0,1,0,0,0,0,0,0,1,586,0,1,587,0
60,24,395,60,14,1,0,1,1,0,1,2,0,3,502,0,3,505,0
61,37,486,77,21,0,1,1,0,0,0,0,1,0,624,0,4,628,0
62,36,482,47,0,0,1,0,0,0,0,0,1,1,568,0,8,576,0
63,188,315,46,48,0,1,1,0,0,0,2,3,1,605,0,4,609,0
64,303,283,18,19,1,0,0,0,0,3,1,1,7,636,0,7,643,0
65,84,359,30,19,0,1,0,0,0,0,0,0,0,493,0,5,498,0
66,205,293,19,5,0,0,0,0,0,0,0,0,2,524,0,5,529,0
67,397,210,15,18,0,2,1,0,1,0,1,1,1,647,0,4,651,0
68,69,557,47,4,0,0,0,0,1,0,0,0,2,680,0,3,683,0
69,47,676,24,10,0,0,0,0,0,0,0,0,8,765,0,1,766,0
70,216,474,26,22,0,0,0,0,0,1,0,0,5,744,0,9,753,0
71,179,221,35,41,1,0,0,0,0,1,0,0,0,478,0,7,485,0
72,562,134,2,4,0,2,0,1,0,2,0,0,0,707,0,4,711,0
73,263,248,16,6,0,0,0,0,0,0,0,0,1,534,0,2,536,0
74,123,255,17,5,0,0,0,0,0,1,1,0,0,402,0,3,405,0
75,40,383,34,16,0,1,0,0,0,1,1,0,0,476,0,1,477,0
76,40,285,17,12,2,0,1,1,0,1,0,0,3,362,0,5,367,0
77,27,402,27,7,0,0,0,0,0,0,0,1,2,466,0,5,471,0
78,59,428,38,8,0,1,0,0,1,1,0,0,2,538,0,4,542,0
79,168,329,32,1,1,0,1,0,0,0,0,1,0,533,0,7,540,0
80,10,358,32,12,0,0,0,0,0,0,0,1,0,413,0,3,416,0
81,66,414,35,37,2,0,0,0,0,0,0,0,2,556,0,5,561,0
82,164,292,43,21,1,0,0,0,0,0,0,1,2,524,0,4,528,0
83,64,222,19,15,0,0,0,0,0,0,0,0,2,322,0,2,324,0
84,69,356,37,24,2,1,0,0,0,2,1,0,0,492,0,3,495,0
85,26,435,27,16,0,0,0,0,0,0,1,3,4,512,0,8,520,0
86,155,325,21,21,1,0,0,0,0,0,2,1,2,528,0,2,530,0
87,74,283,20,22,0,1,0,0,0,2,1,2,1,406,0,4,410,0
88,171,313,42,45,2,0,2,0,0,3,4,1,4,587,0,4,591,0
89,83,358,30,27,1,0,0,0,0,0,0,0,0,499,0,1,500,0
90,86,326,25,29,0,0,0,0,1,0,0,1,0,468,0,9,477,0
91,28,457,26,32,0,0,0,0,0,0,0,1,0,544,0,2,546,0
92,52,212,32,7,0,0,0,0,0,0,1,0,1,305,0,3,308,0
93,73,374,21,61,0,0,0,1,0,2,0,1,2,535,0,8,543,0
94,40,276,21,49,0,0,0,0,1,2,0,0,0,389,0,1,390,0
95,55,289,28,11,1,0,1,0,1,0,0,1,0,387,0,3,390,0
96,113,319,26,26,3,0,0,0,0,0,0,1,4,492,0,2,494,0
97,28,469,17,24,1,0,0,0,0,0,1,0,7,547,0,3,550,0
98,45,348,26,18,0,1,0,0,0,0,0,2,4,444,0,1,445,0
99,30,454,33,25,0,0,0,0,0,0,0,0,2,544,0,5,549,0
100,45,313,14,35,0,0,1,0,0,0,0,0,1,409,0,1,410,0
101,20,388,26,4,0,0,1,1,0,0,0,1,2,443,0,4,447,0
102,29,372,35,23,0,0,0,1,0,0,0,1,1,462,0,4,466,0
103,24,430,23,9,1,0,0,0,0,1,0,1,2,491,0,4,495,0
104,14,432,32,25,1,1,0,0,0,0,0,1,4,510,0,0,510,0
105,9,483,42,32,0,1,0,0,0,0,0,0,1,568,0,4,572,0
106,13,591,37,26,0,2,1,1,0,1,0,1,0,673,0,5,678,0
107,78,354,28,38,1,2,0,1,0,1,0,0,1,504,0,6,510,0
108,14,685,62,41,0,0,0,0,0,2,1,2,6,813,0,6,819,0
109,13,552,25,45,1,0,0,0,0,0,0,1,3,640,0,2,642,0
110,9,551,40,18,2,1,0,1,1,0,0,0,3,626,0,5,631,0
111,5,407,17,17,0,0,0,0,1,0,0,2,2,451,0,4,455,0
112,77,172,29,29,0,0,0,0,0,1,0,1,1,310,0,2,312,0
113,149,198,39,16,0,0,0,0,1,1,1,0,0,405,0,10,415,0
114,38,474,27,49,2,0,1,0,1,0,3,1,2,598,0,6,604,0
115,162,562,25,19,1,3,0,0,0,0,2,0,3,777,0,3,780,0
116,26,677,38,41,2,1,1,2,1,0,3,3,12,807,0,6,813,0
117,22,614,45,21,1,0,0,0,0,0,0,4,1,708,0,1,709,0
118,185,110,14,15,0,0,1,0,0,0,0,0,0,325,0,5,330,0
119,40,382,24,26,1,0,0,0,1,1,0,1,2,478,0,6,484,0
120,65,315,20,24,0,1,0,0,0,0,0,0,0,425,0,4,429,0
121,12,435,25,15,2,0,1,0,0,0,2,3,1,496,0,0,496,0
122,20,735,33,58,1,2,0,1,0,0,1,1,5,857,0,3,860,0
123,17,617,55,28,1,0,1,1,0,1,0,1,3,725,0,1,726,0
124,20,615,69,27,2,0,1,0,0,1,0,1,7,743,0,4,747,0
125,16,639,36,23,0,0,1,0,0,1,0,1,2,719,0,4,723,0
126,79,141,20,4,14,1,0,0,0,1,0,1,0,261,0,2,263,0
127,127,158,39,5,31,1,0,0,0,0,1,0,2,364,0,4,368,0
128,614,186,22,18,3,2,1,0,0,4,5,1,1,857,0,13,870,0
129,233,260,27,16,4,0,1,1,1,1,1,5,5,555,0,7,562,0
130,44,625,52,37,4,1,0,1,1,1,0,2,1,769,0,8,777,0
131,63,485,28,30,1,0,0,2,0,0,0,0,1,610,0,2,612,0
132,95,629,21,22,0,0,1,0,0,0,0,3,2,773,0,3,776,0
133,402,122,14,10,42,1,0,0,0,2,0,0,0,593,0,8,601,0
134,306,317,39,21,16,0,1,0,2,0,0,3,3,708,0,5,713,0
135,250,146,26,16,36,0,1,0,1,0,0,2,0,478,0,3,481,0
136,130,392,26,46,0,0,0,0,0,0,0,0,2,596,0,9,605,0
137,26,743,36,23,2,3,2,0,0,1,3,5,3,847,0,3,850,0
138,19,674,51,25,2,0,1,2,1,0,1,2,6,784,0,7,791,0
139,17,518,49,23,1,1,0,1,0,1,2,1,4,618,0,3,621,0
140,14,538,62,35,3,0,1,0,0,0,0,3,5,661,0,6,667,0
141,40,612,83,47,1,0,0,0,0,1,2,5,7,798,0,4,802,0
142,24,698,66,34,2,0,1,2,3,2,2,6,12,852,0,13,865,0
143,20,788,47,40,3,1,0,0,0,2,2,1,5,909,0,5,914,0
144,105,214,24,16,0,0,0,0,0,0,0,0,1,360,0,1,361,0
145,36,599,52,51,3,5,0,0,0,2,1,1,0,750,0,6,756,0
146,167,318,39,29,0,0,0,0,1,0,1,1,1,557,0,7,564,0
147,63,365,31,37,0,0,0,0,0,0,1,1,0,498,0,7,505,0
148,23,581,39,31,0,0,0,0,0,3,0,1,1,679,0,4,683,0
149,24,586,40,27,3,1,0,0,0,2,2,1,3,689,0,1,690,0
150,13,543,35,26,1,2,0,0,1,1,0,0,6,628,0,5,633,0
151,210,352,16,31,0,0,3,1,0,1,0,2,0,616,0,7,623,0
152,13,475,58,35,1,0,0,1,0,0,0,1,1,585,0,7,592,0
153,242,379,42,46,0,0,3,0,0,0,1,0,1,714,0,7,721,0
154,387,73,31,31,0,0,0,0,0,0,0,0,1,523,0,11,534,0
155,346,162,36,66,1,0,1,4,0,2,2,1,0,621,0,3,624,0
156,184,180,30,24,2,0,0,0,0,0,0,0,0,420,0,7,427,0
157,18,517,43,23,1,0,1,0,1,0,0,0,4,608,0,0,608,0
158,80,440,16,38,2,0,0,2,1,1,0,1,5,586,0,7,593,0
159,228,267,35,88,2,0,3,0,2,1,1,0,1,628,0,4,632,0
160,176,428,42,16,6,0,0,1,1,0,1,0,3,674,0,9,683,0
161,73,661,38,18,2,0,0,1,1,0,0,7,2,803,0,8,811,0
162,31,561,33,17,0,0,0,0,0,0,0,1,3,646,0,6,652,0
163,22,773,42,10,1,1,0,0,0,1,3,3,6,862,0,8,870,0
164,21,879,36,13,0,0,0,0,0,0,0,1,3,953,0,1,954,0
165,54,410,29,10,2,1,1,0,1,0,1,0,2,511,0,3,514,0
166,219,286,53,12,43,0,0,1,1,1,1,2,5,624,0,3,627,0
167,76,541,57,30,7,0,0,1,0,0,2,3,7,724,0,10,734,0
168,491,96,18,20,2,1,0,2,0,0,0,2,2,634,0,10,644,0
169,505,157,28,19,1,0,0,2,1,0,1,0,3,717,0,13,730,0
170,121,434,40,31,2,0,1,0,2,1,2,0,3,637,0,10,647,0
171,180,340,50,64,1,0,0,2,0,1,2,1,4,645,0,4,649,0
172,78,627,33,77,2,1,2,1,0,0,2,1,6,830,0,4,834,0
173,229,80,13,66,3,0,2,0,3,0,0,1,1,398,0,4,402,0
174,14,531,41,45,2,0,0,0,0,0,2,2,1,638,0,4,642,0
175,24,511,41,25,0,0,1,1,0,2,1,2,5,613,0,3,616,0
176,18,459,50,29,1,1,1,0,2,1,1,6,3,572,0,2,574,0
177,507,74,38,7,0,0,0,0,0,1,0,0,0,627,0,9,636,0
178,462,62,19,5,0,0,0,0,0,0,1,0,0,549,0,11,560,0
179,236,199,28,80,3,0,2,0,0,0,1,0,2,551,0,14,565,0
180,316,117,34,67,0,1,0,0,0,1,0,0,0,536,0,7,543,0
181,208,221,30,69,0,0,0,1,0,0,4,0,0,533,0,6,539,0
182,35,646,66,15,2,2,0,1,1,1,0,4,4,777,0,5,782,0
183,61,489,41,20,0,0,0,0,1,2,1,1,6,622,0,7,629,0
184,345,121,17,89,0,0,1,0,2,0,1,0,2,578,0,9,587,0
185,206,105,7,13,1,0,0,0,0,0,2,0,0,334,0,5,339,0
186,208,116,23,52,0,0,0,0,0,2,0,0,0,401,0,6,407,0
187,132,64,14,22,1,0,0,0,0,0,0,0,0,233,0,4,237,0
188,238,210,6,38,0,0,0,1,0,0,2,3,2,500,0,10,510,0
189,171,86,11,34,0,1,0,0,0,0,0,0,0,303,0,12,315,0
190,241,109,24,30,0,2,0,0,0,0,0,0,0,406,0,7,413,0
191,219,114,9,30,0,0,0,0,0,1,4,1,0,378,0,7,385,0
192,203,146,20,31,0,1,0,0,0,0,0,0,1,402,0,6,408,0
193,215,                                                     lis,10,37,0,0,0,0,0,0,0,2,0,382,0,8,390,0
194,181,84,16,52,0,0,0,2,0,0,1,0,0,336,0,8,344,0
195,138,127,11,46,0,2,0,0,0,1,0,0,0,325,0,6,331,0
196,235,274,6,50,1,2,0,0,1,1,0,1,4,575,0,6,581,0
197,237,130,12,48,0,1,1,0,0,0,0,1,0,430,0,9,439,0
198,104,107,7,39,0,0,0,0,0,1,1,0,0,259,0,6,265,0
199,298,123,24,52,0,0,0,0,0,0,0,0,0,497,0,12,509,0
200,181,155,16,42,0,0,0,0,0,1,1,1,0,397,0,14,411,0
201,139,116,15,30,0,1,0,1,0,1,0,0,1,304,0,9,313,0
202,204,136,19,47,0,2,0,1,0,0,1,1,0,411,0,16,427,0
203,219,137,13,49,5,1,0,0,0,1,1,0,0,426,0,15,441,0
204,198,169,13,39,0,2,0,0,0,0,1,1,3,426,0,5,431,0
205,186,141,19,73,0,1,0,0,0,0,1,3,1,425,0,14,439,0
206,160,188,19,65,0,0,0,1,0,1,1,1,1,437,0,15,452,0
207,284,326,8,60,1,2,5,0,1,1,1,1,8,698,0,5,703,0
208,238,202,19,37,1,0,0,0,2,3,2,3,8,515,0,4,519,0
209,124,166,21,86,1,1,1,0,0,0,0,0,1,401,0,9,410,0
210,129,193,12,53,0,0,2,0,0,1,0,1,0,391,0,16,407,0
211,168,143,19,66,1,1,0,0,0,0,0,1,0,399,0,12,411,0
212,222,293,22,69,1,1,4,0,1,3,2,0,1,619,0,8,627,0
213,24,729,48,14,2,0,0,0,1,0,1,2,4,825,0,4,829,0
214,178,32,11,6,0,0,0,0,0,0,0,0,0,227,0,2,229,0
215,97,513,58,28,0,2,1,0,0,0,0,0,3,702,0,0,702,0
216,74,547,45,15,2,2,0,1,0,1,0,0,3,690,0,5,695,0
217,56,410,49,17,1,1,0,0,0,1,0,3,2,540,0,4,544,0
218,183,446,48,33,1,1,2,1,0,1,0,1,1,718,0,10,728,0
219,77,230,15,34,0,1,0,0,0,0,0,1,0,358,0,4,362,0
220,55,271,25,13,0,1,1,0,0,0,0,0,0,366,0,2,368,0
221,100,564,37,18,0,1,1,0,0,0,1,2,2,726,0,2,728,0
222,105,137,31,34,0,0,0,0,0,0,0,0,0,307,0,5,312,0
223,94,235,20,14,0,0,0,0,0,0,1,0,0,364,0,3,367,0
224,39,568,28,14,1,0,0,0,0,0,0,1,2,653,0,2,655,0
225,283,139,8,9,1,0,0,0,0,0,0,0,1,441,0,5,446,0
226,371,92,35,14,0,0,0,0,0,1,0,0,0,513,0,9,522,0
227,83,375,36,15,2,2,1,0,0,1,1,0,1,517,0,6,523,0
228,35,615,37,22,0,1,0,1,1,1,2,0,3,718,0,4,722,0
229,499,109,36,18,0,0,1,0,0,0,0,0,0,663,0,10,673,0
230,360,101,25,60,0,1,1,0,0,0,0,1,0,549,0,14,563,0
231,279,167,22,8,1,0,0,0,1,0,0,0,1,479,0,7,486,0
232,320,100,11,21,2,0,0,0,0,0,1,0,1,456,0,13,469,0
233,196,104,10,26,0,1,0,0,0,0,0,0,0,337,0,8,345,0
234,156,102,7,9,0,0,0,0,0,0,0,0,0,274,0,8,282,0
235,196,60,4,14,0,1,1,0,0,0,1,0,0,277,0,4,281,0
236,180,133,26,35,0,2,0,0,0,0,0,1,0,377,0,4,381,0
237,308,203,29,33,0,0,1,0,1,0,1,1,1,578,0,12,590,0
238,411,318,14,54,1,4,3,2,2,3,1,2,8,823,0,8,831,0
239,345,287,11,72,1,3,1,1,3,2,0,2,11,739,0,8,747,0
240,410,374,14,62,3,3,1,1,2,5,1,2,16,894,0,3,897,0
241,367,346,11,37,1,1,3,0,1,1,1,0,7,776,0,6,782,0
242,227,52,12,7,0,2,0,0,0,0,0,0,0,300,0,3,303,0
243,217,97,15,23,3,4,0,0,1,2,0,1,3,366,0,2,368,0
244,133,87,7,14,0,1,0,0,0,0,0,0,0,242,0,1,243,0
245,362,177,22,31,1,8,0,0,0,0,0,1,2,604,0,14,618,0
246,286,78,23,17,0,5,0,0,0,0,0,0,0,409,0,7,416,0
247,366,59,14,14,0,2,0,0,0,1,0,0,1,457,0,7,464,0
248,550,76,13,10,0,1,0,0,0,0,0,0,0,650,0,7,657,0
249,593,44,16,3,0,0,0,0,0,0,1,0,0,657,0,12,669,0
250,307,28,21,0,0,0,1,0,0,1,1,0,0,359,0,5,364,0
251,447,146,26,23,1,1,2,0,0,0,2,2,1,651,0,10,661,0
252,253,78,22,1,1,0,0,0,0,0,0,0,1,356,0,7,363,0
253,150,85,14,18,0,0,0,0,0,1,0,0,0,268,0,4,272,0
254,113,61,4,6,0,3,0,0,1,0,0,3,1,192,0,2,194,0
255,239,113,18,19,1,0,0,0,0,1,0,0,1,392,0,6,398,0
256,247,107,11,22,0,0,0,1,0,1,1,1,1,392,0,6,398,0
257,352,133,11,17,0,2,0,1,1,2,0,0,2,521,0,10,531,0
258,391,106,46,16,0,0,0,0,0,1,0,0,0,560,0,14,574,0
259,341,364,17,58,0,0,0,0,0,0,1,1,2,784,0,6,790,0
260,178,59,22,17,0,1,0,1,0,0,1,0,0,279,0,2,281,0
261,212,84,7,35,0,4,0,0,0,0,0,0,1,343,0,8,351,0
262,392,180,36,43,0,1,1,0,0,0,2,1,1,657,0,9,666,0
263,322,190,18,32,0,1,0,0,0,0,0,0,1,564,0,8,572,0
264,397,143,19,37,0,0,0,0,0,1,0,1,0,598,0,9,607,0
265,213,138,15,19,0,0,1,0,0,0,0,1,0,387,0,4,391,0
266,337,205,14,89,2,2,3,0,1,0,0,0,1,654,0,8,662,0
267,133,120,14,37,0,2,0,0,0,1,0,0,1,308,0,10,318,0
268,360,205,22,42,0,2,0,0,0,0,1,0,2,634,0,13,647,0
269,200,210,7,12,2,1,0,0,0,0,1,0,5,438,0,1,439,0
270,272,241,18,40,0,0,0,0,1,1,1,0,1,575,0,12,587,0
271,229,167,23,76,0,1,0,0,0,0,0,0,0,496,0,19,515,0
272,302,251,32,76,4,3,3,2,0,0,0,4,0,677,0,15,692,0
273,284,234,23,58,0,3,0,1,0,1,1,1,1,607,0,14,621,0
274,122,88,10,30,0,0,0,1,0,2,0,2,0,255,0,7,262,0
275,179,110,9,60,0,2,0,0,0,0,1,0,0,361,0,5,366,0
276,257,231,23,64,1,1,1,0,0,0,0,1,0,579,0,21,600,0
277,307,164,22,7,0,0,0,0,0,0,1,0,0,501,0,1,502,0
278,123,59,15,5,0,0,0,0,0,0,0,0,0,202,0,1,203,0
279,323,255,13,37,1,2,2,0,2,2,1,2,2,642,0,4,646,0
280,292,137,18,37,0,0,0,0,0,0,0,0,0,484,0,9,493,0
281,285,299,17,58,2,0,1,1,0,1,1,3,5,673,0,13,686,0
282,234,268,14,40,1,4,0,0,2,1,2,2,3,571,0,6,577,0
283,288,292,16,46,1,5,2,1,1,4,5,5,4,670,0,2,672,0
284,236,222,34,44,1,0,0,0,1,2,0,0,0,540,0,9,549,0
285,319,265,27,91,1,2,1,0,0,0,0,1,0,707,0,16,723,0
286,83,67,20,34,0,0,0,0,0,1,0,0,0,205,0,3,208,0
287,259,292,40,88,1,2,1,2,0,0,1,0,1,687,0,7,694,0
288,244,173,29,69,0,2,0,0,0,0,0,0,1,518,0,15,533,0
289,212,176,14,70,2,3,0,0,1,1,1,0,1,481,0,5,486,0
290,233,171,24,33,0,1,0,0,0,0,1,0,1,464,0,5,469,0
291,310,262,26,55,3,2,0,0,0,2,0,3,1,664,0,3,667,0
