of Polling Station.1,ADHIKARI SISIR,DIPAK KUMAR DAS,DR. DEBASIS SAMANTA,PARITOSH PATTANAYAK,BARMAN KHOKAN,KENARAM MISRA,MANAS PRADHAN,Total of valid votes,Unnamed: 10,NOTA,Total,Unnamed: 13,Unnamed: 14
1,575,6,344,79,3,3,1,1011,0,5,1016,0,
2,443,5,323,25,1,1,10,808,0,5,813,0,
3,289,4,155,10,0,2,1,461,0,2,463,0,
4,610,10,332,16,1,0,2,971,0,4,975,0,
5,401,10,441,52,2,3,2,911,0,3,914,0,
6,311,4,265,78,0,2,4,664,0,1,665,0,
7,241,5,217,11,0,0,2,476,0,5,481,0,
8,273,3,290,25,1,2,3,597,0,3,600,0,
9,455,10,488,42,4,3,16,1018,0,11,1029,0,
10,549,2,470,21,2,0,3,1047,0,6,1053,0,
11,419,9,369,9,1,1,3,811,0,10,821,0,
12,600,15,244,23,0,2,0,884,0,3,887,0,
13,262,4,198,14,0,1,0,479,0,0,479,0,
14,441,8,429,27,1,3,3,912,0,10,922,0,
15,331,7,313,46,0,2,1,700,0,5,705,0,
16,229,5,320,145,1,7,0,707,0,2,709,0,
17,321,6,285,23,1,1,0,637,0,5,642,0,
18,313,12,300,17,0,4,0,646,0,3,649,0,
19,295,4,221,10,0,0,1,531,0,1,532,0,
20,332,3,176,18,1,1,4,535,0,2,537,0,
21,336,7,380,37,0,2,0,762,0,6,768,0,
22,432,3,239,21,0,1,2,698,0,3,701,0,
23,115,5,490,8,0,2,0,620,0,3,623,0,
24,86,5,537,8,0,2,0,638,0,2,640,0,
25,344,5,420,17,2,2,1,791,0,4,795,0,
26,421,6,270,10,1,1,2,711,0,12,723,0,
27,493,7,478,21,7,6,4,1016,0,7,1023,0,
28,381,3,221,9,1,1,0,616,0,4,620,0,
29,303,2,391,19,1,0,1,717,0,2,719,0,
30,214,5,356,57,3,3,1,639,0,3,642,0,
31,384,10,297,16,0,3,2,712,0,3,715,0,
32,339,6,339,14,1,1,1,701,0,6,707,0,
33,531,6,402,24,2,3,1,969,0,6,975,0,
34,237,7,362,8,0,0,1,615,0,3,618,0,
35,426,8,274,20,2,4,3,737,0,8,745,0,
36,338,4,177,38,5,2,0,564,0,6,570,0,
37,337,8,309,21,4,1,0,680,0,0,680,0,
38,486,9,461,131,6,10,2,1105,0,5,1110,0,
39,336,6,239,33,0,4,0,618,0,5,623,0,
40,326,4,295,22,4,1,3,655,0,5,660,0,
41,349,12,420,21,1,3,0,806,0,5,811,0,
42,277,2,317,31,2,5,3,637,0,6,643,0,
43,378,13,400,73,1,2,2,869,0,4,873,0,
44,353,2,336,16,0,0,1,708,0,3,711,0,
45,421,3,387,17,0,1,1,830,0,3,833,0,
46,205,2,201,17,1,1,1,428,0,1,429,0,
47,358,12,710,65,3,8,4,1160,0,11,1171,0,
48,545,2,503,31,1,0,0,1082,0,3,1085,0,
49,215,7,521,31,1,1,1,777,0,4,781,0,
50,195,4,303,54,1,3,0,560,0,2,562,0,
51,337,8,414,32,4,3,2,800,0,39,839,0,
52,386,4,696,99,3,3,2,1193,0,8,1201,0,
53,600,9,504,67,3,4,1,1188,0,5,1193,0,
54,480,7,403,130,3,9,1,1033,0,5,1038,0,
55,346,11,318,138,5,10,1,829,0,6,835,0,
56,400,7,336,152,2,1,0,898,0,3,901,0,
57,269,5,508,250,4,7,3,1046,0,3,1049,0,
58,227,4,252,158,3,3,5,652,0,2,654,0,
59,179,74,440,113,5,2,4,817,0,2,819,0,
60,239,5,440,187,2,5,2,880,0,4,884,0,
61,362,3,510,9,0,2,3,889,0,4,893,0,
62,375,2,418,18,2,5,1,821,0,3,824,0,
63,213,13,240,78,8,2,2,556,0,5,561,0,
64,443,10,480,91,10,6,4,1044,0,9,1053,0,
65,188,2,234,159,11,3,0,597,0,3,600,0,
66,589,5,525,36,3,4,1,1163,0,11,1174,0,
67,544,7,497,163,18,0,2,1231,0,4,1235,0,
68,591,9,194,44,4,1,1,844,0,8,852,0,
69,294,7,302,12,1,2,1,619,0,3,622,0,
70,480,7,6,15,0,1,0,509,0,5,514,0,
71,592,3,6,12,1,0,1,615,0,2,617,0,
72,391,7,592,67,5,5,8,1075,0,7,1082,0,
73,289,5,407,4,0,1,1,707,0,2,709,0,
74,337,10,486,55,1,5,0,894,0,6,900,0,
75,243,5,336,9,1,2,0,596,0,3,599,0,
76,462,9,495,23,0,2,1,992,0,5,997,0,
77,227,13,564,72,1,5,1,883,0,4,887,0,
78,121,7,369,33,1,2,1,534,0,4,538,0,
79,870,17,18,43,7,0,1,956,0,5,961,0,
80,593,7,65,96,4,2,0,767,0,7,774,0,
81,175,4,428,19,1,0,0,627,0,2,629,0,
82,153,2,322,3,2,1,1,484,0,2,486,0,
83,271,4,346,34,1,2,2,660,0,5,665,0,
84,369,10,516,19,2,4,2,922,0,9,931,0,
85,262,10,480,19,0,3,0,774,0,3,777,0,
86,499,1,32,21,0,0,0,553,0,2,555,0,
87,571,15,68,21,1,1,1,678,0,4,682,0,
88,246,2,389,55,1,4,1,698,0,3,701,0,
89,364,2,306,20,0,1,2,695,0,8,703,0,
90,718,9,250,45,3,1,0,1026,0,6,1032,0,
91,204,3,363,37,1,1,0,609,0,1,610,0,
92,322,5,304,46,3,0,0,680,0,4,684,0,
93,352,2,305,97,1,1,1,759,0,3,762,0,
94,234,3,326,24,1,1,2,591,0,2,593,0,
95,236,5,275,20,0,3,0,539,0,1,540,0,
95,293,6,396,145,2,1,0,843,0,4,847,0,
97,324,5,260,26,0,3,2,620,0,4,624,0,
98,451,6,486,25,2,3,3,976,0,4,980,0,
99,402,15,460,48,3,0,1,929,0,3,932,0,
100,496,5,216,82,1,2,1,803,0,1,804,0,
101,239,5,273,27,1,1,2,548,0,2,550,0,
102,222,2,222,36,1,3,0,486,0,1,487,0,
103,364,7,160,67,0,3,2,603,0,2,605,0,
104,503,3,412,152,4,2,0,1076,0,4,1080,0,
105,369,10,304,104,3,2,1,793,0,5,798,0,
106,459,5,503,79,1,5,2,1054,0,1,1055,0,
107,407,3,487,48,0,2,1,948,0,3,951,0,
108,358,7,261,50,1,4,3,684,0,2,686,0,
109,610,11,194,71,2,4,4,896,0,4,900,0,
110,753,9,309,81,5,3,0,1160,0,3,1163,0,
111,450,6,463,176,2,8,3,1108,0,3,1111,0,
112,321,8,180,176,2,5,0,692,0,5,697,0,
113,565,6,546,48,6,5,2,1178,0,9,1187,0,
114,603,11,361,166,3,3,0,1147,0,2,1149,0,
115,524,6,437,82,2,0,1,1052,0,5,1057,0,
116,446,4,423,64,0,2,3,942,0,5,947,0,
117,276,5,374,36,1,1,0,693,0,4,697,0,
118,290,2,355,125,0,1,1,774,0,4,778,0,
119,499,7,349,67,4,0,2,928,0,2,930,0,
120,446,4,293,139,3,0,2,887,0,6,893,0,
121,278,9,287,55,2,2,1,634,0,3,637,0,
122,302,2,390,79,1,6,1,781,0,1,782,0,
123,200,4,229,18,0,0,1,452,0,3,455,0,
124,606,10,295,51,1,0,2,965,0,10,975,0,
125,892,10,152,58,1,7,2,1122,0,8,1130,0,
126,852,15,41,122,0,0,0,1030,0,0,1030,0,
127,679,10,22,79,0,0,1,791,0,0,791,0,
128,307,3,589,45,5,3,3,955,0,8,963,0,
129,614,4,113,37,0,0,1,769,0,0,769,0,
130,472,9,416,151,4,2,2,1056,0,4,1060,0,
131,277,4,245,5,0,1,0,532,0,2,534,0,
132,375,4,352,17,0,2,1,751,0,3,754,0,
133,395,10,443,9,2,1,2,862,0,6,868,0,
134,260,3,289,48,2,0,1,603,0,6,609,0,
135,288,1,207,34,0,1,0,531,0,0,531,0,
136,544,12,169,100,0,0,2,827,0,1,828,0,
137,332,3,179,91,2,1,1,609,0,2,611,0,
138,460,4,391,15,0,1,1,872,0,3,875,0,
139,451,4,543,4,2,1,0,1005,0,2,1007,0,
140,415,8,470,54,0,2,1,950,0,3,953,0,
141,540,8,317,45,1,3,2,916,0,0,916,0,
142,600,7,347,57,2,3,3,1019,0,7,1026,0,
143,392,13,292,28,2,5,1,733,0,3,736,0,
144,490,6,454,14,2,2,0,968,0,7,975,0,
145,337,3,252,14,0,0,1,607,0,4,611,0,
146,279,4,385,6,0,4,2,680,0,3,683,0,
147,520,6,423,12,2,2,0,965,0,6,971,0,
148,499,8,507,56,2,2,4,1078,0,9,1087,0,
149,551,4,357,18,0,1,1,932,0,7,939,0,
150,491,7,421,25,1,3,1,949,0,8,957,0,
151,273,4,250,25,0,0,0,552,0,3,555,0,
152,381,5,274,38,1,0,0,699,0,7,706,0,
153,531,36,342,192,4,3,0,1108,0,6,1114,0,
154,733,61,230,41,3,2,3,1073,0,1,1074,0,
155,443,16,480,40,1,2,0,982,0,7,989,0,
156,307,5,216,21,0,2,0,551,0,3,554,0,
157,378,6,336,34,1,2,1,758,0,2,760,0,
158,301,3,243,25,1,2,0,575,0,0,575,0,
159,681,8,157,29,2,2,1,880,0,3,883,0,
160,655,8,10,16,0,3,0,692,0,4,696,0,
161,602,50,55,16,0,0,1,724,0,0,724,0,
162,441,23,468,80,4,5,0,1021,0,4,1025,0,
163,322,12,431,61,2,1,2,831,0,14,845,0,
164,449,7,253,11,1,1,1,723,0,3,726,0,
165,351,7,56,11,1,1,0,427,0,2,429,0,
166,375,5,534,22,1,0,1,938,0,5,943,0,
167,432,17,280,63,3,0,1,796,0,2,798,0,
168,431,8,371,60,1,2,1,874,0,0,874,0,
169,192,4,351,71,1,0,4,623,0,3,626,0,
170,346,8,398,55,2,2,1,812,0,2,814,0,
171,303,12,596,148,2,6,2,1069,0,7,1076,0,
172,304,8,392,121,3,2,1,831,0,2,833,0,
173,561,12,540,41,2,2,1,1159,0,7,1166,0,
174,129,4,169,272,14,16,1,605,0,2,607,0,
175,237,4,165,76,1,2,0,485,0,4,489,0,
176,294,3,276,101,0,5,0,679,0,2,681,0,
177,167,2,184,137,1,3,0,494,0,3,497,0,
178,455,6,383,155,0,6,0,1005,0,2,1007,0,
179,312,7,291,25,2,3,0,640,0,1,641,0,
180,158,5,135,132,0,1,1,432,0,3,435,0,
181,378,9,301,144,1,2,1,836,0,1,837,0,
182,334,3,238,92,0,2,1,670,0,6,676,0,
183,450,4,315,103,3,3,1,879,0,5,884,0,
184,516,7,345,42,3,3,0,916,0,10,926,0,
185,360,5,283,77,2,2,0,729,0,9,738,0,
186,441,4,338,45,0,1,1,830,0,5,835,0,
187,423,6,410,157,2,7,1,1006,0,5,1011,0,
188,324,7,221,185,0,3,1,741,0,3,744,0,
189,332,3,309,45,0,1,1,691,0,2,693,0,
190,401,5,238,256,4,5,3,912,0,6,918,0,
191,406,4,149,179,0,1,1,740,0,4,744,0,
192,592,10,404,124,3,3,5,1141,0,8,1149,0,
193,290,2,243,108,1,0,2,646,0,2,648,0,
194,494,4,234,177,5,3,3,920,0,2,922,0,
195,460,1,365,223,4,5,2,1060,0,6,1066,0,
196,204,3,177,59,1,3,0,447,0,2,449,0,
197,280,2,304,34,1,1,0,622,0,3,625,0,
198,321,9,460,61,1,1,0,853,0,13,866,0,
199,478,12,467,83,3,3,1,1047,0,6,1053,0,
200,354,4,551,126,2,7,3,1047,0,7,1054,0,
201,394,2,464,12,0,0,7,879,0,3,882,0,
202,450,5,307,113,2,2,12,892,0,3,895,0,
203,261,8,253,51,1,0,0,574,0,5,579,0,
204,273,7,398,48,1,1,3,731,0,4,735,1,
205,271,10,494,98,2,1,0,876,0,8,884,0,
206,445,9,446,97,2,3,7,1009,0,7,1016,0,
207,326,5,404,37,1,1,1,775,0,4,779,0,
208,453,5,435,63,0,5,3,964,0,1,965,0,
209,543,11,383,143,2,5,2,1089,0,5,1094,0,
210,399,13,154,140,2,1,2,711,0,4,715,0,
211,369,2,268,91,3,1,1,735,0,4,739,0,
212,211,3,204,72,0,2,2,494,0,1,495,0,
213,436,10,559,37,1,7,9,1059,0,4,1063,0,
214,192,4,356,42,1,5,0,600,0,2,602,0,
215,432,7,265,48,2,4,1,759,0,6,765,0,
216,372,3,245,67,0,5,1,693,0,3,696,0,
217,393,6,343,279,0,3,2,1026,0,7,1033,0,
218,385,9,610,106,2,5,5,1122,0,17,1139,0,
219,358,1,197,114,0,2,1,673,0,1,674,0,
220,291,8,306,382,5,7,0,999,0,4,1003,0,
221,444,3,194,217,6,5,0,869,0,6,875,0,
222,453,8,620,44,2,3,4,1134,0,1,1135,0,
223,357,7,356,173,0,1,1,895,0,3,898,0,
224,335,4,375,28,1,2,1,746,0,1,747,0,
225,463,10,158,16,2,0,0,649,0,1,650,0,
226,387,7,169,28,1,0,0,592,0,5,597,0,
227,605,9,375,30,1,5,0,1025,0,4,1029,0,
228,508,1,190,96,2,0,0,797,0,5,802,0,
229,416,2,162,51,2,1,0,634,0,3,637,0,
230,417,10,172,187,3,10,1,800,0,8,808,0,
231,352,8,334,55,1,0,3,753,0,1,754,0,
232,377,8,194,410,4,3,1,997,0,4,1001,0,
233,549,4,424,125,3,4,2,1111,0,1,1112,0,
234,465,8,487,81,4,12,2,1059,0,5,1064,0,
235,436,4,405,24,1,1,1,872,0,3,875,0,
236,404,53,139,142,0,1,0,739,0,2,741,0,
237,335,36,52,53,0,0,0,476,0,0,476,0,
238,574,7,313,56,2,2,0,954,0,4,958,0,
239,642,5,193,146,3,1,1,991,0,4,995,0,
240,544,6,461,106,1,6,0,1124,0,10,1134,0,
241,637,7,392,137,0,5,0,1178,0,7,1185,0,
242,285,5,195,14,0,1,0,501,0,1,502,0,
243,275,3,403,14,4,1,1,701,0,3,704,0,
244,190,2,252,13,1,0,1,459,0,1,460,0,
245,420,2,285,19,1,2,3,732,0,8,740,0,
246,306,6,683,70,7,1,4,1077,0,4,1081,0,
247,239,5,135,29,0,0,0,408,0,5,413,0,
248,332,6,329,77,0,5,0,749,0,4,753,0,
249,386,8,399,52,0,1,1,847,0,8,855,0,
250,321,6,393,70,2,5,3,800,0,2,802,0,
251,390,8,214,56,0,2,1,671,0,5,676,0,
252,397,8,411,59,5,4,2,886,0,8,894,0,
253,554,8,342,40,0,3,3,950,0,6,956,0,
254,280,9,313,29,1,1,3,636,0,2,638,0,
1,270,2,351,30,2,0,4,659,0,6,665,0,
2,499,5,532,14,3,1,0,1054,0,4,1058,0,
3,430,17,361,10,0,0,1,819,0,3,822,0,
4,570,10,547,18,3,0,2,1150,0,6,1156,0,
5,442,38,391,15,2,0,3,891,0,5,896,0,
6,498,11,338,23,0,0,2,872,0,3,875,0,
7,275,4,263,6,0,1,0,549,0,2,551,0,
8,399,3,342,7,1,1,2,755,0,3,758,0,
9,316,4,340,3,0,2,0,665,0,2,667,0,
10,219,3,409,45,0,0,3,679,0,7,686,0,
11,518,3,425,5,0,0,1,952,0,3,955,0,
12,357,0,390,6,2,2,0,757,0,2,759,0,
13,385,7,266,7,4,1,4,674,0,3,677,0,
14,386,1,443,12,1,2,3,848,0,4,852,0,
15,478,13,399,21,0,4,0,915,0,7,922,0,
15,335,7,459,34,0,3,1,839,0,5,844,0,
17,262,2,254,3,2,1,1,525,0,2,527,0,
18,439,9,305,6,0,1,1,761,0,4,765,0,
19,487,5,385,18,1,2,1,899,0,5,904,0,
20,562,9,474,43,0,2,4,1094,0,10,1104,0,
21,342,9,413,44,2,5,2,817,0,4,821,0,
22,564,9,382,40,1,4,1,1001,0,4,1005,0,
23,444,1,82,7,0,1,1,536,0,2,538,0,
24,465,5,293,9,0,1,13,786,0,1,787,0,
25,573,3,436,25,2,3,12,1054,0,5,1059,0,
26,364,2,302,14,0,0,1,683,0,3,686,0,
27,503,6,426,14,2,0,5,956,0,7,963,0,
28,335,1,339,22,1,1,2,701,0,3,704,0,
29,460,7,357,54,0,6,1,885,0,5,890,0,
30,480,8,225,6,1,0,0,720,0,1,721,0,
31,462,7,401,41,0,3,0,914,0,5,919,0,
32,368,3,252,28,4,2,0,657,0,3,660,0,
33,348,3,364,30,2,3,8,758,0,3,761,0,
34,502,5,320,24,1,1,2,855,0,2,857,0,
35,479,8,284,90,4,2,2,869,0,19,888,0,
36,230,5,230,242,1,5,0,713,0,4,717,0,
37,207,1,288,28,2,0,0,526,0,1,527,0,
38,369,4,490,22,2,4,1,892,0,1,893,0,
39,481,3,469,9,1,0,0,963,0,1,964,0,
40,254,2,269,9,2,0,0,536,0,1,537,0,
41,340,2,284,32,1,2,3,664,0,4,668,0,
42,261,5,266,30,1,2,0,565,0,4,569,0,
43,444,6,395,10,1,2,1,859,0,3,862,0,
44,406,13,422,21,2,0,2,866,0,6,872,0,
45,474,11,327,21,0,1,2,836,0,2,838,0,
46,503,9,359,25,0,0,0,896,0,4,900,0,
47,465,18,430,20,1,1,1,936,0,8,944,0,
48,423,11,374,16,2,0,1,827,0,8,835,0,
49,386,5,344,46,1,4,0,786,0,4,790,0,
50,336,6,428,20,1,2,0,793,0,0,793,0,
51,495,15,337,9,2,1,0,859,0,1,860,0,
52,453,9,391,12,0,0,1,865,0,3,869,0,
53,609,9,293,17,0,0,0,928,0,3,931,0,
54,341,12,424,22,3,3,1,806,0,5,811,0,
55,425,4,288,33,1,2,2,755,0,1,756,0,
56,315,8,385,17,2,2,2,731,0,3,734,0,
57,342,8,381,4,0,1,1,737,0,1,738,0,
58,185,1,214,27,1,1,0,429,0,3,432,0,
59,539,10,501,44,2,0,6,1102,0,3,1105,0,
60,378,2,386,18,1,2,0,787,0,6,793,0,
61,245,2,389,54,2,3,0,695,0,3,698,0,
62,339,5,283,24,0,4,3,658,0,5,663,0,
63,609,6,358,7,2,1,2,985,0,4,989,0,
64,278,6,389,9,0,2,1,685,0,1,686,0,
65,557,17,165,188,2,4,3,936,0,3,939,0,
66,532,5,338,21,0,1,1,898,0,4,902,0,
67,632,24,158,46,2,2,1,865,0,7,872,0,
68,574,28,97,17,1,1,1,719,0,2,721,0,
69,194,8,329,14,1,0,2,548,0,1,549,0,
70,528,18,129,100,3,1,1,780,0,3,783,0,
71,518,10,31,112,4,0,1,676,0,3,679,0,
72,527,8,71,73,1,5,2,687,0,1,688,0,
73,644,28,306,89,0,2,1,1070,0,10,1080,0,
74,375,6,413,11,3,0,2,810,0,1,811,0,
75,551,5,495,57,4,2,2,1116,0,4,1120,0,
76,323,6,639,38,1,3,1,1011,0,3,1014,0,
77,574,16,432,69,5,0,0,1096,0,3,1099,0,
78,351,2,233,23,0,1,0,610,0,3,613,0,
79,343,5,385,25,3,3,5,769,0,2,771,0,
80,668,9,421,5,1,0,1,1105,0,6,1111,0,
81,601,16,231,9,0,0,4,861,0,5,866,0,
82,414,4,10,10,0,0,0,438,0,0,438,0,
83,439,9,438,6,1,6,2,901,0,4,905,0,
84,403,4,409,4,3,1,1,825,0,9,834,0,
85,340,7,327,14,1,0,0,689,0,3,692,0,
86,386,5,387,9,0,1,5,793,0,5,798,0,
87,720,9,332,50,3,1,2,1117,0,8,1125,0,
88,406,8,466,64,0,8,12,964,0,7,971,0,
89,289,5,396,15,1,4,0,710,0,3,713,0,
90,412,11,422,26,2,0,2,875,0,5,880,0,
91,400,6,311,24,3,1,1,746,0,3,749,0,
92,343,11,671,73,3,2,1,1104,0,5,1109,0,
93,194,5,241,32,1,0,2,475,0,7,482,0,
94,413,13,496,14,1,3,1,941,0,3,944,0,
95,280,3,327,25,2,1,0,638,0,5,643,0,
96,393,6,392,9,2,0,1,803,0,7,810,0,
97,244,5,198,1,0,0,0,448,0,1,449,0,
98,493,6,392,8,2,0,0,901,0,3,904,0,
99,516,7,247,16,0,2,1,789,0,2,791,0,
100,543,4,237,20,1,0,1,806,0,1,807,0,
101,272,7,227,10,0,1,2,519,0,2,521,0,
102,298,3,356,8,0,1,0,666,0,1,667,0,
103,270,12,401,20,4,2,1,710,0,8,718,0,
104,327,6,332,14,3,5,2,689,0,7,696,0,
105,375,7,371,26,0,5,6,790,0,17,807,0,
106,301,9,341,14,0,2,1,668,0,1,669,0,
107,305,11,363,21,0,0,0,700,0,2,702,0,
108,314,9,317,16,5,3,1,665,0,4,669,0,
109,366,4,241,9,0,2,2,624,0,5,629,1,
110,308,6,338,2,0,2,1,657,0,2,659,0,
111,360,7,364,25,1,2,3,762,0,3,765,0,
112,457,11,331,24,2,0,2,827,0,5,832,0,
113,476,3,486,11,2,2,1,981,0,7,988,1,
114,318,5,351,7,3,1,1,686,0,1,687,0,
115,764,3,10,90,6,3,3,879,0,13,892,0,
116,634,8,11,175,0,0,0,828,0,7,835,0,
117,609,6,19,177,4,3,1,819,0,0,819,0,
118,307,9,325,155,1,2,2,801,0,5,806,0,
119,320,19,343,136,2,2,0,822,0,6,828,0,
120,485,8,280,71,4,1,3,852,0,5,857,0,
121,519,7,396,44,5,2,1,974,0,10,984,0,
122,524,9,559,40,7,2,6,1147,0,2,1149,0,
123,380,13,433,117,2,6,13,964,0,8,972,0,
124,250,4,302,13,1,1,0,571,0,3,574,0,
125,620,20,82,141,5,2,2,872,0,7,879,0,
126,330,2,392,9,1,1,0,735,0,4,739,0,
127,196,13,291,69,1,1,0,571,0,1,572,0,
128,325,4,419,32,0,3,1,784,0,5,789,0,
129,329,5,343,17,0,0,2,696,0,3,699,0,
130,301,4,488,31,2,1,4,831,0,6,837,0,
131,542,6,468,23,2,2,1,1044,0,3,1047,0,
132,569,12,468,47,3,3,0,1102,0,11,1113,0,
133,422,4,334,42,4,2,1,809,0,5,814,0,
134,372,7,370,51,1,1,3,805,0,4,809,0,
135,416,11,316,102,2,2,6,855,0,6,861,0,
136,537,13,43,182,4,5,1,785,0,7,792,0,
137,137,17,74,125,4,2,0,359,0,4,363,0,
138,669,126,159,46,1,1,2,1004,0,8,1012,0,
139,372,9,252,19,0,2,1,655,0,2,657,0,
140,348,28,238,15,0,1,1,631,0,10,641,0,
141,541,118,123,26,3,2,2,815,0,1,816,0,
142,321,25,131,35,2,1,0,515,0,2,517,0,
143,346,4,389,20,1,2,0,762,0,5,767,0,
144,429,25,393,24,0,5,4,880,0,13,893,0,
145,375,13,357,61,4,4,2,816,0,3,819,0,
146,412,12,30,216,5,2,1,678,0,2,680,0,
147,322,8,395,32,0,1,0,758,0,1,759,0,
148,195,5,264,3,1,0,1,469,0,1,470,0,
149,463,17,275,16,2,2,0,775,0,3,778,0,
150,379,4,478,33,2,1,3,900,0,5,905,0,
151,446,4,412,9,2,1,1,875,0,6,881,0,
152,425,1,370,10,1,1,0,808,0,3,811,0,
153,312,7,342,23,1,3,4,692,0,4,696,0,
154,323,6,323,29,0,2,0,683,0,5,688,0,
155,280,8,511,26,2,2,2,831,0,2,833,0,
156,413,2,204,13,1,3,0,636,0,2,638,0,
157,462,9,429,34,2,3,1,940,0,13,953,0,
158,272,3,403,32,3,3,1,717,0,0,717,0,
159,356,4,236,7,1,2,1,607,0,2,609,0,
160,317,3,204,8,1,0,0,533,0,0,533,0,
161,408,7,213,47,1,1,0,677,0,5,682,0,
162,494,8,624,24,2,4,1,1157,0,2,1159,0,
163,294,4,411,20,2,3,1,735,0,5,740,0,
164,301,3,345,18,1,5,3,676,0,2,678,0,
165,353,5,497,14,1,2,0,872,0,2,874,0,
166,472,12,399,8,2,2,1,896,0,9,905,0,
167,425,6,355,17,2,2,1,808,0,6,814,0,
168,283,10,276,24,2,3,1,599,0,4,603,0,
169,274,10,385,93,6,7,2,777,0,8,785,0,
170,431,13,514,97,5,1,3,1064,0,8,1072,0,
171,342,10,609,70,4,4,6,1045,0,11,1056,0,
172,314,8,469,66,0,2,1,860,0,4,864,0,
173,370,4,321,48,0,5,1,749,0,6,755,0,
174,318,15,424,50,4,0,0,811,0,2,813,0,
175,256,7,457,18,2,0,3,743,0,5,748,0,
176,472,38,228,33,3,1,2,777,0,5,782,0,
177,335,13,638,69,4,7,3,1069,0,8,1077,0,
178,463,12,211,155,6,3,0,850,0,4,854,0,
179,211,6,414,20,3,0,1,655,0,5,660,0,
180,240,4,307,36,0,2,0,589,0,4,593,0,
181,399,3,333,22,0,2,2,761,0,1,762,0,
182,287,7,306,13,2,2,1,618,0,2,620,0,
183,263,2,328,29,3,0,1,626,0,3,629,0,
184,208,2,296,25,1,0,1,533,0,2,535,0,
185,495,10,571,63,3,7,3,1152,0,11,1163,0,
186,392,4,387,69,3,2,2,859,0,8,867,0,
187,447,12,602,57,0,1,0,1119,0,3,1122,0,
188,491,7,494,44,4,2,0,1042,0,11,1053,0,
189,181,3,210,5,1,2,2,404,0,3,407,0,
190,430,4,540,28,2,1,1,1006,0,5,1011,0,
191,510,6,464,24,1,1,1,1007,0,5,1012,0,
192,370,33,312,127,3,5,0,850,0,6,856,0,
193,253,6,293,39,3,3,2,599,0,4,603,0,
194,372,9,309,40,0,0,2,732,0,1,733,0,
195,307,4,252,17,0,0,0,580,0,6,586,0,
196,474,8,111,16,1,0,0,610,0,6,616,0,
197,485,8,380,72,2,5,5,957,0,8,965,0,
198,319,16,371,48,2,1,5,762,0,4,766,0,
199,358,9,408,33,2,0,2,812,0,5,817,0,
200,346,11,426,33,0,0,1,817,0,1,818,0,
201,450,7,384,17,0,6,4,868,0,6,874,0,
202,596,20,211,11,1,1,1,841,0,4,845,0,
203,301,8,278,23,2,0,1,613,0,5,618,0,
204,388,6,207,9,2,3,3,618,0,5,623,0,
205,342,5,390,8,1,2,3,751,0,5,756,0,
206,446,9,470,14,2,4,2,947,0,1,948,0,
207,366,9,421,18,1,1,1,817,0,1,818,0,
208,483,10,318,17,1,2,1,832,0,5,837,0,
209,414,10,506,24,1,3,1,959,0,8,967,0,
210,428,8,537,15,0,2,4,994,0,3,997,0,
211,372,3,407,14,0,2,2,800,0,8,808,0,
212,295,2,480,29,3,3,1,813,0,3,816,0,
213,405,6,467,62,0,2,5,947,0,1,948,0,
214,527,10,606,19,4,5,0,1171,0,8,1179,0,
215,437,17,469,12,0,3,8,946,0,1,947,0,
216,317,11,261,8,2,0,6,605,0,4,609,0,
217,420,11,353,20,1,3,5,813,0,4,817,0,
218,486,10,519,14,5,5,0,1039,0,2,1041,0,
219,495,4,499,16,1,3,1,1019,0,4,1023,0,
220,284,7,202,5,1,5,0,504,0,7,511,0,
221,572,6,531,13,1,2,7,1132,0,3,1135,0,
222,366,9,340,20,0,1,10,746,0,2,748,0,
223,377,9,179,10,4,5,2,586,0,6,592,0,
224,677,13,467,39,1,4,2,1203,0,10,1213,0,
225,382,9,348,18,1,0,2,760,0,7,767,0,
226,341,9,264,16,0,1,0,631,0,1,632,0,
227,381,8,393,10,0,1,1,794,0,5,799,0,
228,260,6,211,8,0,0,0,485,0,1,486,0,
229,329,13,516,13,1,3,4,879,0,10,889,0,
230,590,8,401,26,3,7,3,1038,0,7,1045,0,
231,521,6,590,29,3,3,1,1153,0,11,1164,0,
232,392,7,242,13,0,0,0,654,0,3,657,0,
233,629,6,81,10,1,0,2,729,0,2,731,0,
234,307,7,270,22,1,0,1,608,0,5,613,0,
235,435,4,179,23,2,2,0,645,0,0,645,0,
236,521,6,243,62,1,4,1,838,0,5,843,0,
237,538,8,237,31,2,5,2,823,0,11,834,0,
238,527,9,583,7,3,2,0,1131,0,5,1136,0,
239,270,2,213,13,2,2,0,502,0,1,503,0,
240,370,9,247,122,1,5,4,758,0,7,765,0,
241,356,    S,288,99,2,2,1,753,0,5,758,0,
242,447,9,339,71,3,1,7,877,0,7,884,0,
243,400,8,337,71,5,4,3,828,0,2,830,0,
244,274,7,181,119,0,1,0,582,0,3,585,0,
245,240,7,193,22,0,1,0,463,0,0,463,0,
246,370,5,326,12,1,1,0,715,0,3,718,0,
1,366,10,360,29,1,3,0,769,0,8,777,0,
2,224,8,338,6,1,2,0,579,0,3,582,0,
3,215,6,287,15,0,1,0,524,0,2,526,0,
4,532,12,415,27,5,7,0,998,0,5,1003,0,
5,429,23,504,48,5,2,5,1016,0,9,1025,0,
6,309,7,441,20,0,3,0,780,0,6,786,0,
7,278,4,194,12,2,5,0,495,0,4,499,0,
8,280,8,361,15,3,2,1,670,0,5,675,0,
9,267,4,256,28,4,3,0,562,0,5,567,0,
10,462,9,317,19,1,0,0,808,0,6,814,0,
11,389,6,257,12,1,0,1,666,0,0,666,0,
12,524,4,195,12,1,0,1,737,0,1,738,0,
13,337,12,279,33,0,1,3,665,0,5,670,0,
14,473,13,321,27,0,0,2,836,0,5,841,0,
15,400,6,418,41,3,2,0,870,0,8,878,0,
16,372,8,377,25,4,1,2,789,0,6,795,0,
17,370,9,289,57,5,3,2,735,0,3,738,0,
18,431,39,174,199,3,6,1,853,0,14,867,0,
19,363,6,645,59,6,7,2,1088,0,8,1096,0,
20,512,32,202,241,7,12,1,1007,0,7,1014,0,
21,480,5,419,33,1,1,2,941,0,7,948,0,
22,573,12,400,36,3,3,19,1046,0,2,1048,0,
23,282,3,62,3,0,0,5,355,0,0,355,0,
24,708,8,359,35,2,4,1,1117,0,13,1130,0,
25,518,7,257,5,2,3,2,794,0,9,803,0,
26,471,14,326,25,2,3,4,845,0,5,850,0,
27,466,3,308,20,1,5,0,803,0,2,805,0,
28,536,12,308,33,4,4,1,898,0,7,905,0,
29,614,5,183,10,1,1,2,816,0,3,819,0,
30,431,4,151,9,1,1,1,598,0,4,602,0,
31,670,2,314,32,1,2,1,1022,0,5,1027,0,
32,299,7,123,6,0,0,1,436,0,2,438,0,
33,319,10,200,16,0,0,2,547,0,1,548,0,
34,409,9,186,25,1,0,3,633,0,3,636,0,
35,453,6,159,13,2,0,1,634,0,5,639,0,
36,461,6,150,16,1,0,0,634,0,6,640,0,
37,431,5,166,12,1,3,2,620,0,5,625,0,
38,433,6,213,14,2,0,2,670,0,7,677,1,
39,501,3,102,7,0,0,1,614,0,3,617,0,
40,425,13,525,118,4,3,2,1090,0,10,1100,0,
41,228,8,294,39,1,0,1,571,0,1,572,0,
42,308,17,278,98,2,0,1,704,0,8,712,0,
43,500,9,387,88,2,5,1,992,0,7,999,0,
44,366,8,396,120,3,3,1,897,0,1,898,0,
45,319,5,367,183,1,5,2,882,0,1,883,0,
46,317,8,311,170,0,4,2,812,0,2,814,0,
47,434,5,348,36,0,1,1,825,0,3,828,0,
48,216,3,148,16,0,1,0,384,0,1,385,0,
49,545,8,404,48,2,6,1,1014,0,9,1023,0,
50,472,6,314,36,1,1,2,832,0,4,836,0,
51,334,3,417,23,2,1,0,780,0,5,785,0,
52,480,11,419,30,1,3,1,945,0,7,952,0,
53,305,12,163,5,1,1,0,487,0,5,492,0,
54,280,6,311,141,1,4,0,743,0,9,752,0,
55,323,4,427,18,1,2,0,775,0,3,778,0,
56,489,12,420,48,0,3,2,974,0,3,977,0,
57,415,4,168,9,0,1,0,597,0,5,602,0,
58,565,4,118,16,1,1,4,709,0,3,712,0,
59,534,7,115,14,1,2,2,675,0,1,676,0,
60,412,5,531,30,1,1,7,987,0,12,999,0,
61,252,10,318,16,2,3,8,609,0,9,618,0,
62,231,5,429,18,3,3,5,694,0,9,703,0,
63,379,10,330,27,3,1,13,763,0,1,764,0,
64,423,10,303,110,4,1,1,852,0,5,857,0,
65,307,2,238,10,0,1,0,558,0,1,559,0,
66,227,4,192,20,2,3,2,450,0,1,451,0,
67,140,6,354,29,1,0,1,531,0,4,535,0,
68,360,3,259,5,1,1,0,629,0,2,631,0,
69,332,8,189,8,0,2,1,540,0,2,542,0,
70,342,6,110,11,0,0,11,480,0,1,481,0,
71,586,7,222,21,0,4,13,853,0,2,855,0,
72,265,3,290,69,0,1,6,634,0,5,639,0,
73,313,3,220,26,1,0,4,567,0,4,571,0,
74,385,11,471,64,0,1,1,933,0,1,934,0,
75,306,4,281,61,0,1,0,653,0,0,653,0,
76,554,26,314,118,6,9,7,1034,0,11,1045,0,
77,556,11,428,41,2,1,0,1039,0,4,1043,0,
78,312,9,232,40,0,1,3,597,0,2,599,0,
79,404,10,410,23,0,4,0,851,0,3,854,0,
80,256,6,378,23,2,4,3,672,0,8,680,0,
81,356,7,359,22,0,1,0,745,0,6,751,0,
82,446,9,404,53,3,2,14,931,0,4,935,0,
83,363,6,381,11,0,1,3,765,0,9,774,0,
84,264,11,326,20,1,1,1,624,0,1,625,0,
85,469,7,243,54,2,4,1,780,0,2,782,0,
86,404,15,439,22,5,3,5,893,0,4,897,0,
87,319,6,219,17,1,0,2,564,0,3,567,0,
88,593,12,449,33,2,1,11,1101,0,12,1113,0,
89,388,5,338,5,1,2,3,742,0,3,745,0,
90,361,4,411,13,1,1,14,805,0,0,805,0,
91,521,6,228,157,3,2,3,920,0,8,928,0,
92,558,8,274,24,3,1,2,870,0,7,877,0,
93,370,14,390,11,0,2,0,787,0,4,791,0,
94,359,6,301,19,1,5,1,692,0,6,698,0,
95,392,9,401,111,2,2,2,919,0,9,928,0,
96,359,0,308,14,1,1,0,683,0,0,683,0,
97,302,5,263,38,0,3,1,612,0,4,616,0,
98,228,4,272,83,1,1,0,589,0,0,589,0,
99,581,15,341,53,4,4,0,998,0,7,1005,0,
100,407,10,330,54,1,4,3,809,0,5,814,0,
101,223,5,136,52,1,2,1,420,0,7,427,0,
102,377,8,340,15,2,5,0,747,0,5,752,0,
103,274,10,395,38,4,2,2,725,0,4,729,0,
104,408,3,285,55,0,0,4,755,0,9,764,0,
105,415,6,298,60,4,1,3,787,0,5,792,0,
105,276,6,334,16,2,4,2,640,0,5,645,0,
107,332,2,140,1,0,0,0,475,0,0,475,0,
108,316,1,161,94,1,0,1,574,0,2,576,0,
109,310,7,220,86,1,4,2,630,0,2,632,0,
110,385,9,127,136,1,0,1,659,0,6,665,0,
111,300,6,141,142,2,3,2,596,0,2,598,0,
112,314,8,283,58,2,2,1,668,0,2,670,0,
113,271,2,268,18,1,0,3,563,0,5,568,0,
114,209,14,318,59,2,0,0,602,0,6,608,0,
115,291,3,302,30,3,2,0,631,0,4,635,0,
116,188,5,287,16,0,0,1,497,0,3,500,0,
117,345,7,331,37,1,3,3,727,0,1,728,0,
118,336,10,277,21,1,0,1,646,0,5,651,0,
119,230,2,301,34,2,2,0,571,0,0,571,0,
120,500,9,368,21,2,3,0,903,0,6,909,0,
121,350,9,320,52,5,1,1,738,0,9,747,0,
122,276,2,257,16,0,0,3,554,0,0,554,0,
123,304,7,323,25,3,1,2,665,0,4,669,0,
124,285,23,333,29,2,2,2,676,0,4,680,0,
125,107,25,219,24,0,1,1,377,0,1,378,0,
126,435,18,459,19,1,3,0,935,0,9,944,0,
127,325,16,340,21,2,1,2,707,0,8,715,0,
128,441,9,351,39,2,3,5,850,0,10,860,0,
129,326,26,283,14,2,1,2,654,0,2,656,0,
130,181,3,162,22,0,1,1,370,0,4,374,0,
131,301,4,267,155,3,3,3,736,0,6,742,0,
132,217,8,404,25,0,0,2,656,0,1,657,0,
133,168,2,167,44,0,0,4,385,0,1,386,0,
134,392,6,425,89,3,2,0,917,0,3,920,0,
135,146,10,720,17,2,6,3,904,0,5,909,0,
136,283,6,209,29,0,3,0,530,0,4,534,0,
137,213,12,420,18,0,3,2,668,0,5,673,0,
138,309,22,644,47,3,2,3,1030,0,7,1037,0,
139,215,11,308,14,1,0,0,549,0,4,553,0,
140,367,33,134,95,0,5,1,635,0,13,648,0,
141,263,10,262,16,0,2,2,555,0,1,556,0,
142,231,11,241,79,2,1,1,566,0,4,570,0,
143,509,15,437,86,3,4,5,1059,0,14,1073,0,
144,621,43,293,155,6,2,3,1123,0,8,1131,0,
145,501,35,271,72,5,8,12,904,0,16,920,0,
146,580,49,271,137,3,11,4,1055,0,10,1065,0,
147,158,10,244,62,1,4,2,481,0,5,486,0,
148,188,18,473,49,2,12,2,744,0,13,757,0,
149,665,4,40,6,0,1,0,716,0,3,719,0,
150,138,10,715,15,1,6,3,888,0,5,893,0,
151,318,24,219,67,3,5,2,638,0,7,645,0,
152,230,26,218,17,0,0,1,492,0,2,494,0,
153,296,13,570,37,2,7,3,928,0,5,933,0,
154,632,7,18,4,0,0,0,661,0,2,663,0,
155,248,6,119,7,1,0,0,381,0,2,383,0,
156,551,6,55,1,0,0,0,613,0,3,616,0,
157,476,4,161,3,2,0,1,647,0,3,650,0,
158,544,9,120,6,3,1,0,683,0,8,691,0,
159,632,10,161,8,2,1,1,815,0,3,818,0,
160,448,10,213,13,1,1,2,688,0,7,695,0,
161,248,3,164,5,0,0,0,420,0,3,423,0,
162,300,6,407,11,7,4,4,739,0,4,743,0,
163,348,7,336,19,4,2,3,719,0,5,724,0,
164,352,13,389,15,5,4,2,780,0,5,785,0,
165,268,7,413,8,1,5,3,705,0,3,708,0,
166,400,11,298,21,1,1,1,733,0,7,740,0,
167,307,5,330,17,1,3,1,664,0,4,668,0,
168,309,16,253,21,2,1,2,604,0,7,611,0,
169,412,31,368,28,8,7,2,856,0,7,863,0,
170,167,11,140,8,0,1,0,327,0,2,329,0,
171,482,20,184,13,1,1,4,705,0,7,712,0,
172,599,7,96,7,0,0,1,710,0,2,712,0,
173,486,27,507,29,3,3,42,1097,0,8,1105,0,
174,389,23,327,28,1,2,2,772,0,4,776,0,
175,660,14,165,19,1,1,5,865,0,3,858,0,
176,479,3,105,30,0,0,0,617,0,2,619,0,
177,480,10,179,6,0,0,0,675,0,4,679,0,
178,669,45,279,47,0,2,2,1044,0,9,1053,0,
179,666,41,188,21,1,0,0,917,0,6,923,0,
180,836,6,152,13,1,0,1,1009,0,6,1015,0,
181,440,6,175,17,1,2,1,642,0,8,650,0,
182,280,6,197,33,2,5,0,523,0,5,528,0,
183,343,13,400,40,1,0,1,798,0,3,801,0,
184,192,6,410,26,2,3,2,641,0,1,642,0,
185,461,17,265,29,2,4,0,778,0,3,781,0,
186,205,33,212,12,0,1,1,464,0,6,470,0,
187,302,10,393,82,5,3,1,796,0,4,800,0,
188,185,8,292,61,1,0,0,547,0,5,552,0,
189,340,10,445,17,2,1,1,816,0,12,828,0,
190,199,11,236,17,2,0,3,468,0,1,469,0,
191,368,8,388,30,2,3,2,801,0,3,804,0,
192,230,11,277,13,0,0,0,531,0,4,535,0,
193,471,9,508,40,2,3,1,1034,0,5,1039,0,
194,313,2,317,19,2,2,4,659,0,6,665,0,
195,370,7,175,75,2,1,2,632,0,3,635,0,
196,348,9,276,22,1,4,4,664,0,5,669,0,
197,343,13,467,92,2,5,0,922,0,7,929,0,
198,296,9,450,80,4,4,1,844,0,5,849,0,
199,454,26,119,115,3,1,1,719,0,5,724,0,
200,309,15,449,48,0,1,1,823,0,2,825,0,
201,129,2,176,15,2,0,1,325,0,2,327,0,
202,269,9,582,28,2,7,1,898,0,4,902,0,
203,402,13,679,22,4,11,5,1136,0,12,1148,0,
204,365,9,585,20,2,5,2,988,0,9,997,0,
205,405,13,673,46,2,5,5,1149,0,5,1154,0,
206,306,11,540,137,4,3,3,1004,0,4,1008,0,
207,243,0,98,1,0,2,0,344,0,1,345,0,
208,366,19,349,14,0,4,1,753,0,7,760,0,
209,350,4,417,18,1,3,0,793,0,0,793,0,
210,199,3,328,14,0,1,2,547,0,3,550,0,
211,303,6,278,12,0,1,0,600,0,1,601,0,
212,588,14,322,31,1,0,3,959,0,7,966,0,
213,338,34,28,60,3,1,1,465,0,4,469,0,
214,486,22,570,15,1,5,3,1102,0,5,1107,0,
215,343,4,351,19,3,4,3,727,0,4,731,0,
216,197,2,235,10,3,1,1,449,0,4,453,0,
217,257,16,412,74,1,1,2,763,0,3,766,0,
218,155,6,509,33,9,4,3,719,0,2,721,0,
219,360,11,484,51,2,0,0,908,0,13,921,0,
220,356,2,332,34,2,2,0,728,0,3,731,0,
221,215,1,317,49,2,2,0,586,0,6,592,0,
222,384,17,279,23,2,1,3,709,0,11,720,0,
223,164,7,280,25,0,1,0,478,0,0,478,0,
224,308,5,626,45,4,8,1,997,0,6,1003,0,
   22S,201,5,391,87,1,5,5,695,0,7,702,0,
225,284,4,406,85,2,4,0,785,0,5,790,0,
227,122,3,260,11,1,1,0,398,0,3,401,0,
228,301,1,337,7,0,1,0,647,0,4,651,0,
229,215,7,316,11,1,1,3,554,0,0,554,0,
230,487,11,605,9,3,1,2,1118,0,10,1128,0,
231,554,8,493,12,1,1,1,1070,0,7,1077,0,
232,265,8,335,156,6,5,3,778,0,3,781,0,
233,377,8,355,114,3,4,1,863,0,5,869,0,
234,294,8,513,58,5,8,1,887,0,10,897,0,
235,366,79,384,171,14,11,5,1030,0,12,1042,0,
236,864,47,70,103,4,7,1,1096,0,8,1104,0,
237,423,31,461,70,2,8,2,997,0,6,1003,0,
238,198,35,721,44,2,1,0,1001,0,3,1004,0,
239,551,58,281,181,6,7,4,1088,0,15,1103,0,
240,313,33,490,72,2,6,6,922,0,10,932,0,
241,432,10,449,25,1,2,0,919,0,3,922,0,
242,155,3,401,13,1,9,1,583,0,0,583,0,
243,363,12,243,86,3,2,1,710,0,4,714,0,
244,652,19,19,180,2,6,4,882,0,13,895,0,
245,456,20,256,74,3,5,2,816,0,5,821,0,
246,213,10,423,4,0,2,0,652,0,6,658,0,
247,180,15,314,27,5,1,4,546,0,6,552,0,
248,328,46,409,202,4,4,6,999,0,8,1007,0,
249,393,11,615,42,3,3,3,1070,0,5,1075,0,
250,147,3,243,42,1,6,0,442,0,4,446,0,
251,506,14,483,32,3,2,0,1040,0,5,1045,0,
252,737,17,11,41,0,0,0,806,0,2,808,0,
253,560,23,6,65,2,4,1,661,0,2,663,0,
254,812,31,72,57,1,3,4,980,0,10,990,0,
255,337,5,407,9,4,5,5,772,0,5,777,0,
256,309,22,382,36,6,4,3,762,0,12,774,0,
257,252,7,370,27,3,1,0,660,0,21,681,0,
258,426,18,508,26,8,7,5,998,0,9,1007,0,
259,230,6,479,19,4,3,0,741,0,7,748,0,
260,202,8,336,32,0,2,1,581,0,3,584,0,
261,371,6,492,13,4,5,2,893,0,10,903,0,
262,249,3,277,14,1,3,0,547,0,1,548,0,
263,344,10,371,20,1,1,2,749,0,8,757,0,
264,316,13,386,15,3,1,2,736,0,3,739,0,
265,277,7,391,18,1,1,0,695,0,3,698,0,
266,330,4,492,18,1,4,0,849,0,4,853,0,
267,363,9,337,65,1,2,0,777,0,5,782,0,
268,482,7,412,27,5,5,2,940,0,11,951,0,
269,541,8,587,19,5,5,7,1172,0,10,1182,0,
270,372,16,240,5,2,1,0,636,0,3,639,0,
271,281,16,362,15,0,0,3,677,0,3,680,0,
272,193,4,188,15,0,2,0,402,0,6,408,0,
273,199,6,177,4,0,1,0,387,0,3,390,0,
274,395,14,553,78,7,5,4,1056,0,5,1061,0,
275,388,8,403,42,0,0,1,842,0,6,848,0,
276,261,3,292,16,1,1,0,574,0,1,575,0,
277,172,14,525,31,3,5,3,753,0,7,760,0,
278,252,4,251,17,3,1,5,533,0,4,537,0,
279,398,9,487,156,2,5,4,1061,0,6,1067,0,
280,203,1,294,85,2,4,0,589,0,3,592,0,
281,405,7,387,49,2,5,1,856,0,8,864,0,
282,392,5,419,35,0,3,4,858,0,5,863,0,
1,325,8,389,33,3,2,3,763,0,7,770,0,
2,327,16,331,26,2,2,0,704,0,1,705,0,
3,228,5,257,31,2,2,1,526,0,5,531,0,
4,260,13,343,16,2,1,2,637,0,6,643,0,
5,489,7,548,34,1,0,0,1079,0,4,1083,0,
    e,296,5,317,8,0,1,3,630,0,2,632,0,
7,313,2,260,17,3,2,2,599,0,2,601,0,
8,311,4,290,2,1,0,4,612,0,1,613,0,
9,370,7,433,13,0,0,1,824,0,3,827,0,
10,102,3,272,12,0,1,0,390,0,0,390,0,
11,265,1,214,42,2,0,1,525,0,1,526,0,
12,327,9,324,73,1,7,0,741,0,8,749,1,
13,314,3,141,17,1,2,3,481,0,5,486,0,
14,437,8,400,39,3,6,5,898,0,9,907,0,
15,316,6,423,91,2,0,5,843,0,4,847,0,
16,305,9,330,52,1,1,2,700,0,11,711,0,
17,409,6,341,15,0,1,2,774,0,3,777,0,
18,200,3,242,36,0,0,1,482,0,2,484,0,
19,211,4,284,97,1,3,1,601,0,3,604,0,
20,412,9,458,22,1,0,1,903,0,4,907,0,
21,269,5,262,63,0,0,3,602,0,4,606,0,
22,488,7,358,35,0,2,0,890,0,3,893,0,
23,522,12,368,27,1,0,0,930,0,6,936,0,
24,352,2,595,15,4,2,1,971,0,2,973,0,
25,272,4,340,5,2,4,1,628,0,1,629,0,
26,295,1,272,5,0,1,3,577,0,0,577,0,
27,291,10,349,35,0,1,1,687,0,10,697,0,
28,163,3,250,24,2,0,5,447,0,1,448,0,
29,221,7,509,73,2,3,0,815,0,3,818,0,
30,212,9,359,     H,0,2,1,594,0,2,596,0,
31,622,7,347,51,4,1,1,1033,0,5,1038,0,
32,584,5,260,13,0,2,3,867,0,8,875,0,
33,692,2,11,79,3,3,1,791,0,4,795,0,
34,658,4,158,30,1,1,11,863,0,3,866,0,
35,235,5,418,28,0,4,4,695,0,2,697,0,
36,513,6,309,42,0,6,4,880,0,7,887,0,
37,253,5,340,13,0,3,1,615,0,5,620,0,
38,148,10,668,17,5,4,23,875,0,4,879,0,
39,349,16,362,124,2,4,2,859,0,5,864,0,
40,365,2,420,30,1,2,2,822,0,2,824,0,
41,138,5,319,11,0,2,4,479,0,0,479,0,
42,430,4,556,157,1,4,5,1157,0,3,1160,0,
43,315,2,431,67,2,8,15,840,0,4,844,0,
44,295,0,203,6,2,4,1,511,0,2,513,0,
45,319,10,493,21,3,3,5,854,0,9,863,0,
46,327,4,516,51,1,5,4,908,0,6,914,0,
47,243,2,296,29,2,4,2,578,?   0,4,582,0,
48,347,6,233,35,2,7,0,630,0,9,639,0,
49,492,4,246,73,0,1,1,817,0,7,824,0,
50,476,4,282,49,1,3,1,816,0,3,819,0,
51,773,18,63,44,2,4,1,905,0,6,911,0,
52,727,19,24,29,2,3,0,804,0,2,806,0,
53,230,4,336,129,1,6,1,707,0,3,710,0,
54,428,5,398,66,1,1,2,901,0,4,905,0,
55,695,3,8,20,0,1,1,728,0,2,730,0,
56,656,2,17,30,1,0,0,706,0,1,707,0,
57,501,2,257,31,0,0,4,795,0,1,796,2,
58,362,4,366,32,2,1,0,767,0,5,772,0,
59,419,18,477,34,0,0,2,950,0,2,952,0,
60,464,13,331,81,3,2,1,895,0,7,902,0,
61,296,11,393,94,0,2,3,799,0,7,806,0,
62,232,11,346,77,0,3,2,671,0,0,671,0,
63,455,8,577,42,1,3,3,1089,0,9,1098,0,
64,458,13,532,39,1,2,16,1061,0,3,1064,0,
65,279,5,516,94,0,3,2,899,0,5,904,0,
66,124,4,233,31,0,1,0,393,0,3,396,0,
67,210,4,345,22,2,3,0,586,0,0,586,0,
68,341,15,347,20,2,3,0,728,0,6,734,0,
69,500,5,356,64,0,0,1,926,0,4,930,0,
70,540,8,329,56,2,3,2,940,0,1,941,0,
71,286,5,166,125,2,3,2,589,0,0,589,0,
72,283,10,294,187,4,6,2,786,0,6,792,0,
73,338,1,233,19,0,1,2,594,0,2,596,0,
74,238,6,351,13,1,2,0,611,0,1,612,0,
75,433,12,314,24,3,3,8,797,0,7,804,0,
76,313,3,375,114,0,2,3,810,0,6,816,0,
77,311,5,405,82,1,4,5,813,0,3,816,0,
78,145,0,154,74,2,1,0,376,0,0,376,0,
79,367,6,527,89,3,1,0,993,0,4,997,0,
80,464,6,500,66,0,1,1,1038,0,3,1041,0,
81,252,3,294,68,0,1,2,620,0,0,620,0,
82,285,1,372,32,2,2,2,696,0,1,697,0,
83,263,4,316,18,1,0,0,602,0,5,607,0,
84,238,4,421,16,1,1,2,683,0,1,684,0,
85,251,14,447,35,0,0,1,748,0,3,751,0,
86,268,5,519,195,4,3,0,994,0,7,1001,0,
87,269,7,353,233,2,3,1,868,0,5,873,0,
88,285,8,395,19,0,2,2,711,0,0,711,0,
89,349,9,194,64,4,0,0,620,0,3,623,0,
90,237,3,124,9,0,0,0,373,0,0,373,0,
91,446,16,357,39,3,1,0,862,0,9,871,0,
92,448,4,79,222,4,2,4,763,0,3,766,0,
93,305,4,162,240,2,2,1,716,0,1,717,0,
94,486,8,115,230,1,6,0,846,0,5,851,0,
95,440,8,461,9,1,1,1,921,0,3,924,0,
96,491,6,419,15,3,1,2,937,0,4,941,0,
97,267,2,236,13,0,3,1,522,0,1,523,0,
98,347,5,405,14,1,0,1,773,0,1,774,0,
99,383,10,373,100,1,2,5,874,0,3,877,0,
100,412,6,273,37,2,1,3,734,0,3,737,4,
101,268,2,119,37,0,1,2,429,0,1,430,0,
102,293,4,231,76,1,2,0,607,0,0,607,0,
103,326,3,184,122,0,1,1,637,0,3,640,0,
104,211,2,160,64,2,0,0,439,0,2,441,0,
105,297,5,383,17,4,5,2,713,0,0,713,0,
106,461,8,340,77,0,2,2,890,0,4,894,0,
107,460,15,314,30,1,2,1,823,0,6,829,0,
108,499,4,372,66,0,2,5,948,0,5,953,0,
109,469,5,139,117,1,1,0,732,0,5,737,0,
110,293,12,251,49,0,1,2,608,0,6,614,0,
111,567,11,363,67,26,4,2,1040,0,6,1046,0,
112,837,7,137,8,1,0,0,990,0,2,992,0,
113,576,5,231,9,0,2,0,823,0,7,830,0,
114,508,8,291,78,1,1,0,887,0,3,890,0,
115,397,12,258,124,4,8,8,811,0,12,823,0,
116,276,7,260,39,0,2,1,585,0,4,589,0,
117,549,6,313,8,1,1,0,878,0,3,881,0,
118,371,5,163,8,0,1,0,548,0,5,553,0,
119,506,7,314,8,2,2,0,839,0,5,844,0,
120,225,4,276,23,0,2,2,532,0,3,535,0,
121,416,5,196,38,4,1,0,660,0,0,660,0,
122,440,13,277,18,0,2,2,752,0,5,757,0,
123,426,7,296,14,0,2,1,746,0,5,751,0,
124,671,17,301,28,0,1,1,1019,0,3,1022,0,
125,431,12,257,40,0,1,0,741,0,2,743,0,
126,763,13,184,12,0,1,1,974,0,1,975,0,
127,341,4,132,6,0,1,0,484,0,2,486,0,
128,654,5,225,11,2,0,1,898,0,7,905,0,
129,338,3,272,5,1,1,4,624,0,2,626,0,
130,329,3,206,19,2,1,0,560,0,2,562,0,
131,228,1,100,5,0,2,0,336,0,0,336,0,
132,404,6,266,9,0,0,1,686,0,1,687,0,
133,437,9,266,13,1,2,1,729,0,5,734,0,
134,537,6,357,11,2,2,0,915,0,3,918,0,
135,348,6,197,7,0,3,3,564,0,5,569,0,
136,371,5,379,53,3,3,2,816,0,4,820,0,
137,614,12,340,10,0,1,10,987,0,4,991,0,
138,411,5,340,27,1,1,5,790,0,6,796,0,
139,289,1,219,7,0,1,0,517,0,1,518,0,
140,300,7,265,14,0,0,0,586,0,5,591,0,
141,358,7,88,2,0,0,1,456,0,1,457,0,
142,398,2,93,7,1,1,0,502,0,1,503,0,
143,273,3,201,11,3,1,0,492,0,4,496,0,
144,373,7,287,19,0,2,0,688,0,5,693,0,
145,516,6,390,42,1,3,3,961,0,8,969,0,
146,664,10,361,29,1,2,1,1068,0,5,1073,0,
147,416,8,555,33,4,1,4,1021,0,3,1024,0,
148,440,11,372,141,2,2,1,969,0,3,972,0,
149,330,6,496,15,0,0,0,847,0,4,851,0,
150,226,12,404,11,1,1,2,657,0,5,662,0,
151,268,6,304,9,0,0,1,588,0,4,592,0,
152,505,2,400,22,2,1,1,933,0,7,940,0,
153,552,14,353,125,3,7,2,1056,0,8,1064,0,
154,387,13,246,146,11,3,3,809,0,2,811,0,
155,551,14,335,36,3,5,2,946,0,8,954,0,
156,304,5,228,30,1,2,0,570,0,3,573,0,
157,267,8,249,43,3,2,1,573,0,2,575,0,
158,261,4,360,37,0,3,1,666,0,2,668,0,
159,403,7,249,65,2,1,1,728,0,5,733,0,
160,394,10,185,8,3,1,0,601,0,3,604,0,
161,258,2,285,30,3,3,1,582,0,1,583,0,
162,386,9,313,49,4,7,8,776,0,2,778,0,
163,333,17,390,51,0,2,6,799,0,5,804,0,
164,435,8,350,32,1,1,0,827,0,1,828,0,
165,459,12,494,76,3,3,1,1048,0,5,1053,0,
166,445,3,200,34,0,1,0,683,0,2,685,0,
167,398,13,236,16,0,4,0,667,0,3,670,0,
168,434,10,406,74,0,3,2,929,0,2,931,0,
169,554,11,311,48,1,4,1,930,0,4,934,0,
170,437,14,374,238,6,6,3,1078,0,5,1083,0,
171,264,6,167,52,2,3,0,494,0,1,495,0,
172,489,7,190,10,0,1,1,698,0,8,706,0,
173,864,9,9,28,3,1,2,916,0,4,920,0,
174,471,14,474,19,2,2,3,985,0,8,993,0,
175,514,14,269,14,1,3,3,818,0,3,821,0,
176,343,9,189,14,1,2,1,559,0,2,561,0,
177,427,3,427,50,0,3,1,911,0,3,914,0,
178,494,5,376,60,1,2,2,940,0,5,945,0,
179,649,4,221,20,1,0,0,895,0,2,897,0,
180,316,3,231,15,1,1,0,567,0,1,568,0,
181,380,8,383,71,1,6,1,850,0,7,857,0,
182,296,5,214,17,1,1,0,534,0,3,537,0,
183,393,6,364,35,1,6,0,805,0,2,807,0,
184,455,5,148,41,0,0,1,650,0,2,652,0,
185,444,5,179,14,1,0,0,643,0,3,646,0,
186,389,5,312,45,2,2,1,756,0,7,763,0,
187,434,10,193,16,1,1,1,656,0,3,659,0,
188,517,9,283,19,2,2,0,832,0,4,836,0,
189,317,4,413,52,0,3,0,789,0,2,791,0,
190,209,10,242,25,1,1,0,488,0,5,493,0,
191,301,7,209,15,3,0,1,536,0,6,542,0,
192,278,8,318,18,0,3,2,627,0,5,632,0,
193,499,12,459,20,1,5,3,999,0,5,1004,0,
194,531,17,191,166,1,3,2,911,0,2,913,0,
195,217,5,184,7,0,1,0,414,0,1,415,0,
196,743,19,260,23,3,2,0,1050,0,3,1053,0,
197,678,4,173,14,2,0,0,871,0,1,872,0,
198,722,12,125,9,1,2,0,871,0,7,878,0,
199,677,13,281,16,0,1,1,989,0,4,993,0,
200,627,4,123,7,1,0,1,763,0,1,764,0,
201,342,0,61,5,0,0,0,408,0,1,409,0,
202,805,2,11,1,0,0,0,819,0,0,819,0,
203,634,3,43,8,1,1,0,690,0,1,691,0,
204,728,3,21,2,1,0,0,755,0,5,760,0,
205,1036,1,23,2,0,0,0,1062,0,0,1062,0,
206,773,15,138,3,1,0,0,930,0,1,931,0,
207,692,6,94,11,0,0,2,805,0,1,806,0,
208,692,7,196,15,0,0,2,912,0,6,918,0,
209,475,5,161,9,0,1,0,651,0,0,651,0,
210,500,3,58,7,0,0,1,569,0,4,573,0,
211,671,4,54,7,1,0,1,738,0,2,740,0,
212,556,6,100,4,4,3,4,677,0,9,686,0,
213,542,10,256,9,0,1,0,818,0,2,820,0,
214,867,3,103,7,0,1,0,981,0,5,986,0,
215,363,16,246,23,2,0,1,651,0,7,658,0,
216,534,13,320,97,5,3,1,973,0,8,981,0,
217,459,2,224,29,1,0,1,716,0,3,719,0,
218,283,2,158,18,0,0,0,461,0,7,468,0,
219,396,9,233,56,5,5,6,710,0,5,715,0,
220,223,3,230,68,2,2,2,530,0,3,533,0,
221,241,5,172,14,0,0,1,433,0,0,433,0,
222,386,6,390,97,3,3,4,889,0,7,896,0,
223,369,6,469,30,3,3,5,885,0,6,891,0,
224,287,10,235,58,3,1,0,594,0,2,596,0,
225,259,9,210,13,0,1,1,493,0,6,499,0,
225,216,2,161,8,1,2,1,391,0,3,394,0,
227,379,13,358,137,5,5,7,904,0,9,913,0,
228,346,20,342,76,3,8,1,796,0,9,805,0,
229,420,15,332,31,2,2,3,805,0,11,816,0,
230,488,19,372,56,0,0,3,938,0,10,948,0,
231,404,12,560,28,1,7,3,1015,0,12,1027,0,
232,668,9,237,26,1,0,2,943,0,8,951,0,
233,726,10,123,26,1,1,1,888,0,0,888,0,
234,751,3,110,2,0,0,0,866,0,3,869,0,
235,406,3,15,2,0,0,0,426,0,1,427,0,
236,597,2,44,2,1,1,0,647,0,0,647,0,
237,572,14,389,22,1,1,1,1000,0,10,1010,0,
238,278,9,341,17,0,1,2,648,0,3,651,0,
239,509,10,391,52,3,4,2,971,0,7,978,0,
240,805,4,106,1,0,1,1,918,0,1,919,0,
241,394,13,403,24,2,1,2,839,0,5,844,0,
242,657,12,275,33,0,5,0,982,0,5,987,0,
243,627,14,402,21,0,2,0,1066,0,8,1074,0,
244,778,11,267,26,2,2,3,1089,0,13,1102,0,
245,559,18,350,45,3,5,2,982,0,11,993,0,
246,389,7,218,8,0,1,1,624,0,0,624,0,
247,533,17,541,39,4,1,4,1139,0,11,1150,0,
248,599,6,124,14,1,1,1,746,0,2,748,0,
249,468,4,170,14,2,1,0,659,0,9,668,0,
250,475,14,239,16,3,1,3,751,0,5,756,0,
251,623,10,171,12,0,3,0,819,0,5,824,0,
252,630,4,118,11,0,0,0,763,0,1,764,0,
253,343,9,362,15,1,1,1,732,0,2,734,0,
254,659,10,276,64,1,0,2,1012,0,3,1015,0,
255,250,1,150,22,1,2,0,426,0,2,428,0,
256,527,10,328,207,2,2,15,1091,0,5,1096,0,
257,432,10,652,40,5,4,3,1146,0,15,1161,0,
258,370,4,419,147,2,1,6,949,0,8,957,0,
259,364,4,232,59,2,2,9,672,0,1,673,0,
260,463,6,509,75,1,5,1,1060,0,5,1065,0,
261,423,3,325,25,0,2,2,780,0,2,782,0,
262,381,5,372,61,4,3,11,837,0,6,843,0,
263,535,5,429,79,3,2,3,1056,0,6,1062,0,
264,290,4,325,51,1,2,2,675,0,2,677,0,
265,348,2,210,11,1,0,0,572,0,1,573,0,
266,352,4,324,100,3,2,1,786,0,9,795,0,
267,356,6,302,39,1,4,2,710,0,2,712,0,
268,226,7,232,51,0,1,3,520,0,4,524,0,
269,370,4,198,8,0,1,3,584,0,3,587,0,
270,487,2,217,12,0,2,1,721,0,3,724,0,
271,329,5,236,14,2,0,1,587,0,1,588,0,
272,322,7,336,15,0,0,1,681,0,0,681,0,
273,407,12,328,17,2,2,2,770,0,6,776,0,
274,437,8,333,26,2,2,1,809,0,3,812,0,
275,227,5,152,10,0,1,1,396,0,0,396,0,
276,516,7,250,22,1,0,9,805,0,5,810,0,
277,424,2,76,6,0,0,1,509,0,1,510,0,
278,426,7,257,13,1,1,2,707,0,2,709,0,
279,437,7,186,66,0,0,4,700,0,4,704,0,
280,292,7,117,57,0,1,0,474,0,5,479,0,
1,492,7,347,30,1,2,0,879,0,2,881,0,
2,317,1,219,28,1,2,2,570,0,2,572,0,
3,384,6,351,13,0,0,1,755,0,4,759,0,
4,306,6,257,24,0,1,1,595,0,2,597,0,
5,391,7,317,10,3,4,1,733,0,5,738,0,
6,348,4,210,11,1,0,2,576,0,3,579,0,
7,284,3,301,9,1,2,2,602,0,1,603,0,
8,362,7,496,44,4,0,3,916,0,8,924,0,
9,512,6,534,    '  25,1,0,2,1080,0,5,1085,0,
10,377,7,347,7,2,3,2,745,0,3,748,0,
11,507,8,292,22,1,1,2,833,0,6,839,0,
12,436,7,319,15,1,3,4,785,0,2,787,0,
13,220,2,174,18,0,2,1,417,0,3,420,0,
14,483,9,336,22,3,1,3,857,0,7,864,0,
15,471,10,478,29,2,0,7,997,0,8,1005,0,
16,168,10,224,31,1,0,3,437,0,0,437,0,
17,525,10,429,50,0,2,2,1018,0,6,1024,0,
18,526,20,409,45,2,2,1,1005,0,3,1008,0,
19,417,23,381,43,3,6,1,874,0,3,877,0,
20,621,7,428,6,0,2,3,1067,0,3,1070,0,
21,418,3,372,10,0,2,2,807,0,3,810,0,
22,553,6,444,54,2,3,3,1065,0,4,1069,0,
23,345,3,251,23,2,2,2,628,0,3,631,0,
24,368,3,237,7,1,1,0,617,0,2,619,0,
25,355,5,338,65,2,1,5,771,0,2,773,0,
26,329,9,444,53,1,2,4,842,0,5,847,0,
27,424,3,320,29,1,1,2,780,0,5,785,0,
28,244,6,280,34,1,1,1,567,0,0,567,0,
29,457,3,321,24,1,1,0,807,0,4,811,0,
30,358,5,125,6,1,1,2,498,0,4,502,0,
31,449,2,108,12,0,0,1,572,0,3,575,0,
32,338,6,355,23,0,1,5,738,0,4,742,0,
33,184,2,377,12,1,1,0,577,0,2,579,0,
34,360,15,324,17,2,2,1,722,0,5,727,0,
35,355,5,356,15,0,2,1,734,0,2,736,0,
35,480,16,535,52,4,5,8,1100,0,8,1108,0,
37,343,10,459,49,2,1,1,865,0,5,870,0,
38,434,3,409,32,1,4,1,884,0,2,886,0,
39,288,4,444,30,4,4,0,774,0,3,777,0,
40,169,5,250,50,3,2,1,480,0,4,484,0,
41,351,4,276,15,3,0,2,651,0,6,657,0,
42,632,17,407,96,0,6,1,1159,0,7,1166,0,
43,393,13,405,94,2,2,2,911,0,5,916,0,
44,338,3,334,37,1,3,0,716,0,4,720,0,
45,318,11,332,25,3,3,0,692,0,4,696,0,
46,412,10,382,21,0,0,0,825,0,10,835,0,
47,513,10,206,51,0,1,0,781,0,1,782,0,
48,510,15,480,54,2,3,1,1066,0,10,1076,0,
49,337,8,271,43,2,2,1,664,0,5,669,0,
50,301,14,495,34,3,4,2,853,0,6,859,0,
51,310,15,482,31,1,0,2,841,0,2,843,0,
52,544,21,396,56,4,2,4,1027,0,9,1036,0,
53,544,11,378,39,2,6,2,982,0,6,988,0,
54,625,4,444,52,3,5,3,1136,0,5,1141,0,
55,290,30,366,33,4,3,4,730,0,3,733,0,
56,214,9,340,24,2,1,0,590,0,4,594,0,
57,392,9,345,19,1,2,0,768,0,6,774,0,
58,593,20,155,122,2,5,2,899,0,13,912,0,
59,287,13,369,29,0,2,0,700,0,1,701,0,
60,371,8,344,14,0,0,1,738,0,6,744,0,
61,351,7,474,70,4,4,4,924,0,3,927,0,
62,344,9,267,33,1,3,0,657,0,4,661,0,
63,222,2,328,8,5,0,0,565,0,4,569,0,
64,468,15,348,17,0,4,2,854,0,10,864,0,
65,446,15,402,43,1,3,4,914,0,5,919,0,
66,326,11,284,33,4,4,2,664,0,5,669,0,
67,295,7,265,29,2,1,2,602,0,1,603,0,
68,300,6,395,72,0,3,2,778,0,3,781,0,
69,367,8,241,64,2,0,0,682,0,6,688,0,
70,225,7,296,133,4,3,1,669,0,2,671,0,
71,422,8,229,32,1,0,0,692,0,1,693,0,
72,320,2,258,91,3,1,1,676,0,5,681,0,
73,519,11,466,152,2,6,2,1158,0,3,1161,0,
    11?,240,12,692,39,1,2,2,988,0,4,992,0,
75,431,3,643,44,1,2,0,1124,0,2,1126,0,
76,486,5,481,20,0,4,0,996,0,10,1006,0,
77,232,1,131,16,0,1,2,383,0,1,384,0,
78,201,6,275,110,0,2,3,597,0,3,600,0,
79,450,14,446,195,5,4,3,1117,0,7,1124,0,
80,430,14,322,87,4,2,0,859,0,6,865,0,
81,386,4,133,69,1,2,1,596,0,2,598,0,
82,369,13,375,46,5,4,7,819,0,18,837,0,
83,424,7,159,23,1,0,1,615,0,3,618,0,
84,551,17,516,79,1,4,1,1169,0,8,1177,0,
85,837,6,324,45,1,2,4,1219,0,6,1225,0,
86,526,11,384,53,2,3,0,979,0,6,985,0,
87,237,6,224,41,0,1,3,512,0,4,516,0,
88,505,8,222,328,5,4,0,1072,0,2,1074,0,
89,283,5,267,19,0,1,0,575,0,8,583,0,
90,540,9,357,22,0,3,0,931,0,6,937,0,
91,287,12,506,21,5,2,6,839,0,13,852,0,
92,203,6,554,26,2,3,4,798,0,7,805,0,
93,426,9,377,28,0,0,2,842,0,2,844,0,
94,319,9,338,29,2,0,1,698,0,1,699,0,
95,420,10,299,20,1,2,2,754,0,6,760,0,
96,469,9, .     242,6,2,3,3,734,0,7,741,0,
97,479,6,204,7,2,2,1,701,0,6,707,0,
98,431,12,238,10,1,0,3,695,0,6,701,0,
99,329,7,315,26,2,3,0,682,0,2,684,0,
100,498,7,418,10,0,2,1,936,0,2,938,0,
101,668,4,38,105,4,1,1,821,0,8,829,0,
102,468,11,536,22,2,2,1,1042,0,7,1049,0,
103,460,16,585,9,1,2,0,1073,0,5,1078,0,
104,363,10,362,13,1,8,3,760,0,6,766,0,
105,329,4,396,13,1,0,2,745,0,6,751,0,
   lOG,479,8,412,15,1,0,1,916,0,3,919,0,
107,307,2,297,13,1,0,0,620,0,1,621,0,
108,501,7,423,20,1,1,3,956,0,3,959,0,
109,376,10,542,39,2,5,0,974,0,3,977,0,
110,537,7,396,11,1,1,0,953,0,9,962,0,
111,352,9,174,23,1,0,1,560,0,3,563,0,
112,168,3,219,16,2,4,1,413,0,6,419,0,
113,200,3,123,11,0,0,1,338,0,0,338,0,
114,341,6,407,35,2,2,2,795,0,10,805,0,
115,280,8,169,23,0,0,0,480,0,3,483,0,
116,403,9,635,20,2,5,1,1075,0,1,1075,0,
117,370,9,584,36,1,4,1,1005,0,6,1011,0,
118,581,12,333,29,2,2,2,961,0,2,963,0,
119,431,12,380,54,1,6,1,885,0,9,894,0,
120,326,5,275,93,4,3,0,706,0,6,712,0,
121,354,13,309,29,1,4,0,710,0,7,717,0,
122,365,6,318,48,5,1,2,745,0,9,754,0,
123,520,16,475,74,1,2,4,1092,0,10,1102,0,
124,348,14,663,53,5,4,1,1088,0,14,1102,0,
125,442,16,532,42,4,6,1,1043,0,9,1052,0,
126,288,11,265,15,0,2,8,589,0,5,594,0,
127,237,10,207,16,3,2,1,476,0,2,478,0,
128,333,10,371,18,2,6,2,742,0,5,747,0,
129,369,7,299,7,3,0,3,688,0,3,591,0,
130,626,5,249,20,0,0,6,906,0,3,909,0,
131,415,7,215,17,0,2,2,659,0,6,665,0,
132,635,11,327,28,3,2,1,1007,0,7,1014,0,
133,596,13,127,14,1,1,4,756,0,2,758,0,
134,357,1,69,4,0,0,0,431,0,2,433,0,
135,325,4,429,35,0,4,0,797,0,7,804,0,
136,498,0,11,14,1,1,1,526,0,0,526,0,
137,686,20,14,62,2,2,4,790,0,7,797,0,
138,489,7,34,14,0,1,0,545,0,8,553,0,
139,364,3,207,11,0,0,1,586,0,5,591,0,
140,264,5,592,11,4,7,1,884,0,4,888,0,
141,506,5,442,11,1,1,2,968,0,2,970,0,
142,420,13,497,31,2,5,3,971,0,10,981,0,
143,258,8,296,16,1,5,0,584,0,8,592,0,
144,300,7,362,24,0,2,1,696,0,3,699,0,
145,463,4,339,9,0,3,2,820,0,2,822,0,
146,254,1,544,13,2,1,3,818,0,7,825,0,
147,307,6,477,8,1,3,0,802,0,4,806,0,
148,397,8,353,9,2,3,4,776,0,4,780,0,
149,343,7,424,19,3,2,0,798,0,5,803,0,
150,413,8,515,7,1,2,2,948,0,5,953,0,
151,278,4,442,13,2,2,0,741,0,6,747,0,
152,408,7,573,14,1,6,2,1011,0,14,1025,0,
153,351,13,465,13,1,3,1,847,0,1,848,0,
154,287,6,407,13,0,3,9,725,0,9,734,0,
155,315,7,291,11,1,5,2,632,0,5,637,0,
156,329,11,280,18,4,4,1,647,0,7,654,0,
157,365,10,387,20,0,2,3,787,0,6,793,0,
158,381,5,550,24,1,5,2,968,0,3,971,0,
159,370,11,408,29,2,2,1,823,0,3,826,0,
160,308,4,125,11,1,1,1,451,0,3,454,0,
161,629,9,441,7,1,3,2,1092,0,9,1101,0,
162,520,9,196,17,0,1,0,743,0,3,746,0,
163,654,5,281,9,2,3,2,956,0,4,960,1,
164,373,8,256,2,0,0,3,642,0,2,644,0,
165,355,15,163,8,2,0,1,544,0,2,546,0,
166,571,5,0.172,5,1,0,1,755,0,4,759,0,
167,314,24,186,8,2,1,0,535,0,5,540,0,
168,441,5,122,3,0,1,3,575,0,2,577,0,
169,429,3,132,2,2,0,2,570,0,4,574,0,
170,455,7,238,18,2,1,1,722,0,0,722,0,
171,514,3,190,6,1,0,2,716,0,6,722,0,
172,653,8,409,5,1,1,1,1078,0,8,1086,0,
173,356,10,265,15,0,0,2,648,0,6,654,0,
174,344,5,127,6,2,1,2,487,0,4,491,0,
175,419,3,164,8,4,1,1,600,0,7,607,0,
176,492,13,285,3,0,4,3,800,0,9,809,0,
177,226,5,347,11,1,4,2,596,0,3,599,0,
178,248,13,624,23,3,10,3,924,0,9,933,0,
179,148,3,380,4,0,0,0,535,0,4,539,0,
180,267,7,465,14,1,5,3,762,0,5,767,0,
181,417,6,402,20,0,1,1,847,0,5,852,0,
182,288,7,316,24,1,2,1,639,0,6,645,0,
183,445,9,497,11,2,4,2,970,0,9,979,0,
184,659,4,461,7,1,5,2,1139,0,10,1149,0,
185,546,9,367,13,0,2,0,937,0,0,937,0,
186,416,6,293,15,1,2,3,736,0,2,738,0,
187,272,5,297,9,0,0,0,583,0,5,588,0,
   1S8,226,10,436,13,3,5,1,694,0,4,698,0,
189,410,14,522,9,0,5,3,963,0,3,966,0,
190,269,18,620,20,1,4,2,934,0,8,942,0,
191,368,7,492,6,4,2,1,880,0,4,884,0,
192,234,6,243,15,2,1,0,501,0,0,501,0,
193,253,11,352,19,0,6,6,647,0,9,656,0,
194,292,12,676,13,1,2,3,999,0,3,1002,0,
195,453,18,535,52,3,4,3,1068,0,17,1085,0,
196,388,7,532,16,2,2,1,948,0,4,952,0,
197,289,10,449,16,3,3,2,772,0,8,780,0,
198,227,4,262,10,0,1,1,505,0,4,509,0,
199,301,3,346,10,1,0,0,661,0,6,667,0,
200,369,19,465,31,0,3,1,888,0,8,896,0,
201,559,8,404,27,4,2,1,1005,0,5,1010,0,
202,584,18,233,35,1,3,2,876,0,12,888,0,
203,379,5,250,10,1,0,3,648,0,1,649,0,
204,311,10,226,7,1,0,3,558,0,0,558,0,
205,426,7,285,18,1,3,3,743,0,7,750,0,
205,224,7,470,15,1,1,0,718,0,3,721,0,
207,339,5,336,5,3,5,1,694,0,4,698,0,
208,228,8,375,13,1,2,0,627,0,2,629,0,
209,260,9,497,13,0,4,1,784,0,9,793,0,
210,629,17,113,48,3,2,0,812,0,8,820,0,
211,430,21,501,61,11,14,7,1045,0,14,1059,0,
212,287,13,431,24,3,2,2,762,0,6,768,0,
213,94,5,180,6,1,1,2,289,0,1,290,0,
214,387,14,575,20,4,4,1,1005,0,10,1015,0,
215,291,4,339,12,2,4,1,653,0,6,659,0,
216,247,5,305,4,2,5,1,569,0,3,572,0,
217,375,7,411,19,2,5,1,820,0,8,828,1,
218,401,16,465,14,4,7,2,909,0,4,913,0,
219,228,18,623,29,7,4,1,910,0,10,920,0,
220,326,10,631,20,1,6,2,996,0,7,1003,0,
221,256,4,475,19,2,2,1,759,0,6,765,0,
222,200,7,383,8,0,0,1,599,0,1,600,0,
223,308,14,663,17,2,7,3,1014,0,8,1022,0,
224,388,20,470,50,2,5,1,936,0,6,942,0,
225,244,5,167,38,0,1,0,455,0,3,458,0,
226,363,13,507,41,0,3,2,929,0,3,932,0,
227,190,7,400,37,1,8,1,644,0,4,648,1,
228,155,5,390,15,0,2,1,568,0,4,572,0,
229,204,5,248,7,2,1,1,468,0,4,472,0,
230,517,15,577,12,3,2,2,1128,0,5,1133,0,
231,388,10,357,11,1,3,2,772,0,4,776,0,
232,502,12,488,7,1,5,3,1018,0,7,1025,0,
233,177,4,311,3,1,0,1,497,0,2,499,0,
234,410,5,337,12,2,4,6,776,0,13,789,0,
235,221,4,199,2,1,2,1,430,0,3,433,0,
236,288,5,328,16,1,2,2,642,0,2,644,0,
237,294,4,331,3,1,6,1,640,0,5,645,0,
238,377,16,376,36,0,4,5,814,0,2,816,0,
239,694,17,244,65,5,1,2,1028,0,11,1039,0,
240,318,12,273,32,0,3,2,640,0,8,648,0,
241,498,12,520,40,5,1,1,1077,0,6,1083,0,
242,407,10,160,35,2,4,1,619,0,2,621,0,
243,456,13,416,34,0,4,4,927,0,6,933,0,
244,349,7,297,25,0,4,1,683,0,1,684,0,
245,313,5,378,23,1,0,1,721,0,0,721,0,
246,306,8,665,19,6,4,2,1010,0,7,1017,0,
247,286,10,452,9,1,3,0,761,0,11,772,0,
248,210,8,334,9,0,1,0,562,0,3,565,0,
249,246,17,614,32,8,6,2,925,0,8,933,0,
250,265,14,741,15,5,2,1,1043,0,9,1052,0,
251,533,7,528,11,1,1,1,1082,0,7,1089,0,
252,336,14,457,14,6,4,0,831,0,6,837,0,
253,489,11,525,6,0,3,0,1034,0,3,1037,0,
1,277,3,211,61,1,4,0,557,0,1,558,0,
2,348,8,342,69,4,1,1,773,0,3,776,0,
3,373,10,221,208,0,1,1,814,0,1,815,0,
4,325,4,261,45,0,1,2,638,0,6,644,0,
5,484,13,398,38,1,3,3,940,0,7,947,0,
6,431,12,374,62,2,3,2,886,0,5,891,0,
7,287,10,329,70,1,3,1,701,0,4,705,0,
8,401,13,247,112,3,1,0,777,0,5,782,0,
9,527,19,443,28,3,6,1,1027,0,8,1035,0,
10,417,8,427,21,3,6,4,886,0,5,891,0,
11,321,2,387,19,0,4,0,733,0,7,740,0,
12,323,5,366,17,0,1,2,714,0,2,716,0,
13,253,6,161,11,2,1,0,434,0,3,437,0,
14,357,12,265,13,2,3,2,654,0,1,655,0,
15,338,37,217,52,2,3,2,651,0,6,657,0,
16,267,10,298,19,0,3,0,597,0,3,600,0,
17,352,4,390,30,1,6,3,786,0,2,788,0,
18,355,63,257,22,3,2,1,703,0,10,713,0,
19,415,6,441,34,4,3,6,909,0,7,916,0,
20,233,6,215,1,1,1,0,457,0,3,460,0,
21,320,7,304,13,0,1,4,649,0,8,657,0,
22,157,3,134,10,0,1,0,305,0,2,307,0,
23,395,13,278,15,2,0,2,705,0,5,710,0,
24,280,5,332,14,0,0,0,631,0,3,634,0,
25,286,4,371,8,2,4,1,676,0,6,682,0,
26,337,5,357,23,0,3,2,727,0,2,729,0,
27,335,17,421,15,2,2,4,796,0,4,800,0,
28,240,3,207,11,0,0,0,461,0,5,466,0,
29,318,7,484,19,3,1,2,834,0,5,839,0,
30,371,17,352,8,2,2,2,754,0,9,763,0,
31,139,2,204,1,1,1,0,348,0,4,352,0,
32,363,12,406,21,2,5,2,811,0,8,819,0,
33,316,5,237,23,0,2,1,584,0,1,585,0,
34,200,4,278,11,1,1,0,495,0,2,497,0,
35,375,14,340,6,1,0,4,740,0,4,744,0,
36,263,4,181,10,0,7,0,465,0,1,466,0,
37,168,0,135,3,0,1,1,308,0,4,312,0,
38,294,4,345,27,0,1,0,671,0,5,676,0,
39,157,0,185,13,1,0,0,356,0,2,358,0,
40,350,12,436,35,1,7,5,846,0,8,854,0,
41,456,6,318,60,3,1,1,845,0,3,848,1,
42,288,15,284,18,3,0,2,610,0,3,613,0,
43,380,30,410,17,2,2,1,842,0,5,847,0,
44,217,15,186,6,0,2,2,428,0,1,429,0,
45,359,3,196,25,3,7,1,594,0,3,597,0,
46,439,7,226,78,4,3,1,758,0,5,763,0,
47,280,1,168,7,0,0,3,459,0,3,462,0,
48,350,7,204,53,2,2,0,618,0,3,621,0,
49,324,3,208,16,1,2,2,556,0,3,559,0,
50,276,6,185,51,0,5,2,525,0,1,526,0,
51,407,5,303,23,1,3,6,748,0,3,751,0,
52,275,9,387,18,1,0,1,691,0,6,697,0,
53,324,8,363,24,3,2,2,726,0,5,731,0,
54,332,7,217,101,1,2,3,663,0,3,666,0,
55,207,6,195,19,1,3,1,432,0,4,436,0,
56,264,8,244,49,0,2,1,568,0,4,572,0,
57,240,17,269,124,0,1,1,652,0,6,658,0,
58,247,4,287,46,4,1,1,590,0,2,592,0,
59,368,5,308,55,1,1,0,738,0,3,741,0,
60,168,6,221,17,1,0,3,416,0,1,417,0,
61,295,50,189,50,1,1,2,588,0,1,589,0,
62,501,7,274,108,3,1,1,895,0,1,896,0,
63,376,15,370,181,0,6,1,949,0,9,958,0,
64,246,6,255,167,2,1,0,677,0,1,678,0,
65,493,14,496,52,2,4,4,1065,0,10,1075,0,
66,373,2,298,45,1,1,1,721,0,3,724,0,
67,488,6,556,45,3,5,5,1108,0,9,1117,0,
68,434,11,565,17,3,6,2,1038,0,9,1047,0,
69,335,10,387,9,5,2,1,749,0,2,751,0,
70,157,4,393,11,3,2,2,572,0,2,574,0,
71,438,15,491,55,5,3,3,1010,0,3,1013,0,
72,634,29,213,102,2,2,3,985,0,3,988,0,
73,450,15,519,22,2,4,6,1018,0,10,1028,0,
74,541,20,427,70,1,3,2,1064,0,8,1072,0,
75,526,12,508,16,2,0,2,1066,0,9,1075,0,
76,517,13,432,15,2,3,1,983,0,10,993,0,
77,669,16,382,28,0,1,4,1100,0,7,1107,0,
78,487,12,453,50,2,5,5,1014,0,6,1020,0,
79,459,38,191,26,0,1,1,716,0,9,725,0,
80,319,5,278,19,2,0,2,625,0,16,641,0,
81,642,3,274,8,1,1,2,931,0,11,942,0,
82,708,11,280,4,0,1,2,1006,0,11,1017,0,
83,650,18,222,28,0,2,2,922,0,2,924,0,
84,369,11,343,31,1,3,1,759,0,3,762,0,
85,518,12,351,28,4,0,9,922,0,15,937,0,
86,351,13,220,43,0,1,3,631,0,9,640,0,
87,550,9,69,51,2,2,4,687,0,4,691,0,
88,241,8,157,34,3,2,1,446,0,6,452,0,
89,414,11,433,47,1,3,2,911,0,3,914,0,
90,549,10,327,33,1,3,1,924,0,9,933,0,
91,411,10,420,24,1,1,0,867,0,6,873,0,
92,431,4,236,29,1,0,0,701,0,7,708,0,
93,291,4,191,26,0,3,4,519,0,2,521,0,
94,496,8,320,20,1,1,0,846,0,12,858,0,
95,564,11,345,18,0,4,1,943,0,12,955,0,
96,415,15,309,13,2,2,1,757,0,11,768,0,
97,180,3,249,11,1,0,0,444,0,1,445,0,
98,227,12,149,15,0,0,2,405,0,4,409,0,
99,185,3,117,19,0,0,0,324,0,3,327,0,
100,271,8,167,25,2,0,1,474,0,9,483,0,
101,369,10,130,31,0,2,1,543,0,3,546,0,
102,549,23,351,32,2,1,3,961,0,14,975,0,
103,371,12,411,35,0,2,4,835,0,7,842,0,
104,616,14,355,72,2,6,3,1068,0,18,1086,0,
105,410,17,354,26,1,0,0,808,0,5,813,0,
106,163,5,161,15,0,0,0,344,0,7,351,0,
107,262,8,275,41,1,1,2,590,0,5,595,0,
108,445,20,373,42,1,3,0,884,0,7,891,0,
109,371,21,343,60,0,1,1,797,0,12,809,1,
110,376,22,290,35,1,0,6,730,0,9,739,0,
111,251,5,235,41,0,1,3,536,0,2,538,0,
112,317,11,312,55,1,0,1,697,0,6,703,0,
113,273,10,204,20,0,3,1,511,0,9,520,1,
114,462,11,380,27,1,4,3,888,0,7,895,0,
115,346,17,369,16,3,0,2,753,0,7,760,0,
116,277,8,252,17,2,0,4,560,0,9,569,0,
117,527,11,363,41,1,1,12,956,0,11,967,0,
118,464,20,399,38,0,0,1,922,0,14,936,0,
119,894,27,47,77,3,2,1,1051,0,8,1059,0,
120,405,11,371,19,1,0,2,809,0,4,813,0,
121,551,13,279,57,2,0,0,902,0,5,907,0,
122,400,26,82,52,1,0,3,564,0,2,566,0,
123,253,9,331,30,2,0,0,625,0,4,629,0,
124,546,26,346,78,3,2,2,1003,0,8,1011,0,
125,545,23,251,78,1,3,3,904,0,12,916,0,
126,304,9,346,23,1,1,3,687,0,8,695,0,
127,783,18,58,78,2,2,0,941,0,8,949,0,
128,690,52,9,129,2,1,1,884,0,8,892,1,
129,486,14,16,27,2,0,0,545,0,5,550,0,
130,756,14,11,105,0,1,0,887,0,10,897,0,
131,211,3,326,4,2,1,0,547,0,1,548,0,
132,487,29,275,60,1,0,1,853,0,2,855,0,
133,392,14,222,38,1,2,2,671,0,1,672,0,
134,322,8,98,67,1,0,0,496,0,2,498,0,
135,245,8,323,13,1,1,3,594,0,8,602,0,
136,392,8,158,4,2,0,1,565,0,8,573,0,
137,277,14,221,9,2,3,6,532,0,3,535,0,
138,628,23,359,41,3,5,1,1060,0,8,1068,0,
139,264,6,277,37,1,2,13,600,0,2,602,0,
140,317,29,109,47,2,4,4,512,0,8,520,0,
141,471,15,435,14,5,0,2,942,0,1,943,0,
142,270,8,392,8,1,0,1,680,0,6,686,0,
143,184,3,265,3,0,4,1,460,0,3,463,0,
144,893,1,32,0,0,0,1,927,0,1,928,0,
145,662,16,10,34,2,       Q,0,724,0,3,727,0,
146,343,10,10,30,0,1,3,397,0,1,398,0,
147,415,24,219,62,1,4,4,729,0,2,731,0,
148,463,17,485,30,3,1,1,1000,0,7,1007,0,
149,598,72,129,176,6,1,18,1000,0,12,1012,0,
150,504,9,354,11,1,4,19,902,0,5,907,0,
151,243,5,177,29,0,2,2,458,0,3,461,0,
152,360,21,430,22,0,6,38,877,0,10,887,0,
153,389,22,127,13,1,3,5,560,0,4,564,0,
154,236,4,362,3,0,2,4,611,0,5,616,0,
155,223,0,9,103,2,2,2,341,0,1,342,0,
156,274,3,256,8,1,0,0,542,0,4,546,0,
157,429,7,406,18,3,0,2,865,0,3,868,0,
158,277,1,268,26,2,2,2,578,0,2,580,0,
159,347,3,331,16,1,2,2,702,0,9,711,0,
160,585,3,285,17,3,2,0,895,0,9,904,0,
161,358,6,420,55,5,2,0,846,0,12,858,0,
162,339,1,203,6,0,3,0,552,0,3,555,0,
163,331,5,252,9,1,0,0,598,0,1,599,0,
164,244,5,393,10,0,6,2,660,0,5,665,0,
165,320,3,130,16,1,2,1,473,0,2,475,0,
166,434,13,27,90,4,1,0,569,0,4,573,0,
167,550,24,225,152,6,4,4,965,0,14,979,0,
168,275,0,188,18,2,1,2,486,0,4,490,0,
169,149,6,185,7,1,0,0,348,0,1,349,0,
170,359,7,458,7,1,2,1,835,0,5,840,0,
171,310,13,140,66,1,0,1,531,0,6,537,0,
172,558,22,9,130,3,1,0,723,0,9,732,0,
173,308,5,370,11,1,2,0,697,0,1,698,0,
174,280,10,416,7,0,1,0,714,0,0,714,0,
175,584,40,368,22,0,4,4,1022,0,14,1036,0,
176,278,9,285,33,1,1,0,607,0,8,615,0,
177,254,3,181,25,0,0,1,464,0,0,464,0,
178,219,11,250,21,3,2,1,507,0,1,508,0,
179,309,16,360,72,2,1,2,762,0,3,765,0,
180,247,1,145,23,1,0,1,418,0,2,420,0,
181,179,4,142,25,0,1,1,352,0,3,355,0,
182,359,11,509,50,1,3,0,933,0,12,945,0,
183,436,4,339,20,0,1,2,802,0,7,809,0,
184,355,15,535,30,0,2,1,938,0,4,942,0,
185,408,13,363,14,1,2,3,804,0,11,815,0,
186,361,11,430,16,1,1,0,820,0,1,821,0,
187,412,2,363,11,0,2,1,791,0,2,793,0,
188,323,9,189,5,0,1,3,530,0,1,531,0,
189,409,2,319,10,0,3,2,745,0,4,749,0,
190,454,6,277,11,2,1,4,755,0,4,759,0,
191,292,5,395,18,2,1,1,714,0,5,719,0,
192,370,5,311,9,1,11,0,707,0,2,709,0,
193,261,2,148,5,0,0,0,416,0,0,416,0,
194,537,5,441,29,0,4,0,1016,0,7,1023,0,
195,328,6,217,9,1,1,0,562,0,4,566,0,
196,294,4,230,17,0,1,0,546,0,0,546,0,
197,261,7,265,26,0,3,1,563,0,1,564,0,
198,365,5,324,6,2,7,1,710,0,7,717,0,
199,400,6,635,58,0,3,3,1105,0,5,1110,0,
200,350,2,358,11,1,1,2,725,0,3,728,0,
201,311,7,196,1,2,1,1,519,0,1,520,0,
202,550,10,335,10,0,0,1,906,0,3,909,0,
203,341,10,453,26,1,1,3,835,0,8,843,0,
204,383,6,202,12,0,3,0,606,0,3,609,0,
205,428,1,100,2,0,0,1,532,0,1,533,0,
206,285,3,119,5,0,0,0,412,0,0,412,0,
207,297,2,79,1,0,0,1,380,0,0,380,0,
208,492,2,371,19,3,1,0,888,0,5,893,0,
209,242,2,134,10,1,0,1,390,0,1,391,0,
210,335,6,200,2,3,0,3,549,0,6,555,0,
211,470,5,341,13,1,1,1,832,0,3,835,0,
212,250,2,187,4,0,0,1,444,0,4,448,0,
213,252,8,348,5,0,2,1,616,0,4,620,0,
214,292,9,205,3,1,1,0,511,0,4,515,0,
215,290,11,335,19,1,4,1,661,0,5,666,0,
216,309,8,436,13,2,0,1,769,0,7,776,0,
217,331,8,447,18,0,1,3,808,0,3,811,0,
218,165,4,188,42,0,0,0,399,0,1,400,0,
219,188,7,192,27,1,1,0,416,0,1,417,0,
220,340,7,421,46,0,0,6,820,0,3,823,0,
221,268,4,238,127,3,6,2,648,0,6,654,0,
222,231,1,136,131,1,1,0,501,0,2,503,0,
223,236,8,222,9,0,3,5,483,0,2,485,0,
224,229,3,191,32,0,1,1,457,0,2,459,0,
225,405,10,259,22,0,1,1,698,0,2,700,0,
226,378,12,389,32,0,2,2,815,0,6,821,0,
227,330,2,222,93,2,1,0,650,0,3,653,0,
228,229,1,176,134,1,4,0,545,0,0,545,0,
229,599,12,559,29,2,3,7,1211,0,3,1214,0,
230,325,9,334,44,1,1,2,716,0,2,718,0,
231,301,0,290,11,0,0,0,602,0,3,605,0,
232,351,3,323,17,2,1,0,697,0,6,703,0,
233,229,4,203,5,0,2,6,449,0,1,450,0,
234,136,3,236,14,2,0,0,391,0,4,395,0,
235,476,18,469,16,1,3,2,985,0,2,987,0,
236,220,1,157,16,1,0,0,395,0,4,399,0,
237,206,3,269,15,1,2,1,497,0,3,500,0,
238,272,7,261,34,1,0,4,579,0,2,581,0,
239,131,18,217,33,1,1,1,402,0,5,407,0,
240,283,12,304,65,4,3,2,673,0,4,677,0,
241,166,14,279,14,2,4,1,480,0,0,480,0,
242,423,13,391,30,3,0,0,860,0,4,864,0,
243,343,4,341,13,0,3,1,705,0,5,710,0,
244,368,24,375,17,1,1,1,787,0,8,795,0,
245,355,7,526,10,4,2,5,909,0,4,913,0,
246,267,8,272,30,4,8,1,590,0,8,598,0,
247,227,7,590,30,1,4,1,860,0,5,865,0,
248,374,7,259,11,1,2,27,681,0,1,682,0,
249,164,3,286,17,0,0,8,478,0,3,481,0,
250,354,25,296,37,0,3,0,715,0,4,719,0,
251,543,42,542,32,1,0,2,1162,0,9,1171,0,
252,216,6,254,13,1,4,4,498,0,3,501,0,
253,471,6,605,17,2,2,4,1107,0,7,1114,0,
254,482,10,433,10,1,3,3,942,0,2,944,0,
255,251,2,241,3,1,1,0,499,0,2,501,0,
256,242,9,171,9,0,1,0,432,0,0,432,0,
257,238,13,307,12,1,4,3,578,0,8,586,0,
258,304,19,532,120,9,4,2,990,0,16,1006,0,
259,445,12,212,10,2,2,0,683,0,4,687,0,
1,297,7,398,22,2,1,0,727,0,5,732,0,
2,371,3,332,5,0,1,1,713,0,7,720,0,
3,337,9,607,12,5,1,3,974,0,13,987,0,
4,192,5,397,7,1,2,0,604,0,2,606,0,
5,589,10,168,72,2,1,0,842,0,4,846,0,
6,242,7,245,23,1,1,1,520,0,7,527,0,
7,380,13,4,61,1,1,0,460,0,0,460,0,
8,221,11,343,2,1,0,0,578,0,5,583,0,
9,341,6,314,15,0,0,1,677,0,2,679,0,
10,362,4,451,13,1,4,0,835,0,6,841,0,
11,414,5,393,15,3,1,1,832,0,3,835,0,
12,315,2,160,16,1,0,5,499,0,6,505,0,
13,398,6,312,44,1,2,0,763,0,8,771,0,
14,275,2,375,5,2,2,1,662,0,2,664,0,
15,313,3,199,42,1,1,23,582,0,4,586,0,
16,330,9,201,39,1,4,2,586,0,3,589,0,
17,416,4,433,50,1,2,0,906,0,4,910,0,
18,332,5,439,6,1,0,0,783,0,5,788,0,
19,358,5,302,37,2,4,0,708,0,4,712,0,
20,260,7,316,19,1,2,1,606,0,2,608,0,
21,461,6,281,16,1,1,3,769,0,5,774,0,
22,286,1,254,8,1,2,2,554,0,2,556,0,
23,330,7,360,14,1,1,4,717,0,7,724,0,
24,442,5,475,8,3,3,0,936,0,5,941,0,
25,360,7,397,11,2,2,0,779,0,7,786,0,
26,394,9,442,18,1,0,0,864,0,4,868,0,
27,257,3,320,13,0,2,0,595,0,2,597,0,
28,222,6,211,102,1,2,1,545,0,2,547,0,
29,342,8,371,12,2,0,1,736,0,4,740,0,
30,338,4,462,13,1,5,0,823,0,3,826,0,
31,396,8,549,20,3,2,2,980,0,4,984,0,
32,317,8,572,14,2,2,2,917,0,1,918,0,
33,361,1,387,15,0,1,0,765,0,2,767,0,
34,297,2,354,8,0,2,1,664,0,4,668,0,
35,390,8,335,14,0,0,2,749,0,8,757,0,
36,459,8,439,14,3,2,3,928,0,8,936,0,
37,351,8,384,8,1,4,1,757,0,14,771,0,
38,425,13,132,36,0,3,1,610,0,4,614,0,
39,326,2,553,6,4,5,1,897,0,7,904,0,
40,290,2,308,13,1,0,0,614,0,2,616,0,
41,444,8,504,26,5,10,1,998,0,13,1011,0,
42,372,10,119,6,1,0,0,508,0,4,512,0,
43,301,2,292,2,2,0,0,599,0,4,603,0,
44,381,7,550,13,3,1,2,957,0,4,961,0,
45,402,8,473,35,0,2,1,921,0,4,925,0,
46,362,6,541,19,2,3,0,933,0,4,937,0,
47,674,26,11,92,1,5,2,811,0,9,820,0,
48,475,11,26,45,2,1,1,561,0,5,566,0,
49,319,6,298,33,0,1,0,657,0,4,661,0,
50,504,9,28,23,1,1,1,567,0,2,569,0,
51,198,1,324,5,0,2,1,531,0,2,533,0,
52,542,60,14,83,3,1,4,707,0,13,720,0,
53,488,7,322,9,0,1,0,827,0,4,831,0,
54,544,19,27,26,2,3,2,623,0,5,628,0,
55,443,10,79,30,0,0,1,563,0,5,568,0,
56,297,1,306,2,1,0,0,607,0,0,607,0,
57,471,1,395,26,1,1,3,898,0,4,902,0,
58,358,6,440,40,1,4,0,849,0,4,853,0,
59,333,3,444,5,0,4,2,791,0,2,793,0,
60,235,8,334,15,0,1,0,593,0,3,596,0,
61,132,0,171,2,0,1,0,306,0,0,306,0,
62,318,2,529,12,1,1,1,864,0,4,868,0,
63,275,3,301,11,0,0,2,592,0,3,595,0,
64,459,12,125,59,2,4,0,661,0,12,673,0,
65,301,15,276,29,1,1,2,625,0,3,628,0,
66,324,14,520,16,5,4,1,884,0,9,893,0,
67,388,18,248,27,1,5,3,690,0,6,696,0,
68,399,11,457,66,4,4,3,944,0,10,954,0,
69,205,10,163,9,0,4,1,392,0,0,392,0,
70,412,4,8,54,1,1,0,480,0,3,483,0,
71,366,11,88,91,0,0,1,557,0,6,563,0,
72,540,19,254,55,2,4,2,876,0,9,885,0,
73,237,6,447,22,0,4,1,717,0,5,722,0,
74,322,6,397,41,2,2,1,771,0,5,776,0,
75,463,8,403,69,2,7,1,953,0,5,958,0,
76,322,4,421,10,1,2,1,761,0,3,764,0,
77,457,11,383,8,2,2,0,863,0,1,864,0,
78,588,9,432,11,4,2,0,1046,0,13,1059,0,
79,282,2,337,6,2,1,0,630,0,3,633,0,
80,462,7,590,13,1,5,0,1078,0,8,1086,0,
81,597,14,412,97,5,5,3,1133,0,5,1138,0,
82,220,11,319,18,3,1,0,572,0,4,576,0,
83,284,2,290,11,1,1,0,589,0,1,590,0,
84,253,6,385,9,1,3,1,658,0,3,661,0,
85,404,4,276,10,2,1,0,697,0,7,704,0,
86,447,8,246,14,0,0,0,715,0,4,719,0,
87,300,12,322,26,3,0,0,663,0,0,663,0,
88,395,5,365,8,1,1,1,776,0,8,784,0,
89,470,15,612,19,2,4,1,1123,0,10,1133,0,
90,433,10,409,13,0,0,2,867,0,5,872,0,
91,212,5,292,6,0,0,1,516,0,1,517,0,
92,283,14,370,18,2,0,1,688,0,3,691,0,
93,299,6,336,37,0,5,0,683,0,7,690,0,
94,532,30,413,40,0,3,0,1018,0,5,1023,0,
95,674,12,174,92,3,5,0,960,0,8,968,0,
96,568,10,377,36,1,1,2,995,0,4,999,0,
97,323,20,361,63,2,3,1,773,0,13,786,0,
98,506,4,597,16,0,0,2,1125,0,3,1128,0,
99,389,5,363,3,2,2,2,766,0,4,770,0,
100,449,6,215,4,1,0,0,675,0,2,677,0,
101,368,4,260,9,0,0,0,641,0,3,644,0,
102,293,8,243,9,1,5,0,559,0,2,561,0,
103,384,4,413,16,2,1,2,822,0,13,835,0,
104,501,11,418,39,1,4,1,975,0,2,977,0,
105,282,3,358,7,1,2,0,653,0,5,658,0,
106,429,14,579,25,6,4,1,1058,0,11,1069,0,
107,247,2,357,31,0,4,0,641,0,5,646,0,
108,256,3,280,30,1,0,1,571,0,6,577,0,
109,272,19,362,34,2,2,3,694,0,2,696,0,
110,164,13,248,38,0,2,0,465,0,2,467,0,
111,214,14,350,87,4,3,1,673,0,7,680,0,
112,436,7,586,11,4,5,0,1049,0,8,1057,0,
113,456,17,537,27,4,1,2,1044,0,2,1046,0,
114,476,11,651,45,4,5,1,1193,0,17,1210,0,
115,420,8,329,198,4,7,1,967,0,5,972,0,
116,337,12,349,57,3,5,2,765,0,6,771,0,
117,259,15,419,44,1,3,0,741,0,5,746,0,
118,266,3,355,15,3,1,0,643,0,9,652,0,
119,491,13,443,65,2,2,1,1017,0,9,1026,0,
120,243,7,254,14,0,2,0,520,0,4,524,0,
121,251,6,384,28,0,5,2,676,0,16,692,0,
122,384,10,301,61,0,4,1,761,0,3,764,0,
123,506,8,352,81,1,3,2,953,0,5,958,0,
124,221,10,595,68,0,7,0,901,0,3,904,0,
125,333,7,538,36,1,8,5,928,0,7,935,0,
126,290,12,456,233,3,15,3,1012,0,3,1015,0,
127,294,9,329,11,1,1,0,645,0,4,649,0,
128,240,1,456,74,2,7,2,782,0,5,787,0,
129,448,9,583,13,3,4,1,1061,0,12,1073,0,
130,283,24,372,2,1,1,0,683,0,1,684,0,
131,404,6,283,108,1,1,0,803,0,5,808,0,
132,275,5,444,93,1,0,0,818,0,3,821,0,
133,566,8,294,59,2,2,0,931,0,3,934,0,
134,262,3,181,4,0,1,0,451,0,3,454,0,
135,326,12,210,45,0,2,0,595,0,4,599,0,
136,608,9,186,47,0,2,4,856,0,9,865,0,
137,439,10,269,58,3,2,1,782,0,5,787,0,
138,310,6,289,22,0,1,0,628,0,7,635,0,
139,340,3,265,16,2,1,1,628,0,9,637,0,
140,164,6,342,23,5,3,2,545,0,4,549,0,
141,314,16,145,57,1,2,2,537,0,2,539,0,
142,366,8,234,11,1,4,0,624,0,5,629,0,
143,284,5,454,21,1,4,2,771,0,6,777,0,
144,348,6,498,27,3,5,3,890,0,2,892,0,
145,206,17,355,50,0,2,0,630,0,5,635,0,
146,189,4,270,68,0,1,1,533,0,3,536,0,
147,206,5,356,44,5,2,1,619,0,8,627,0,
148,334,13,412,31,1,6,1,798,0,8,806,0,
149,357,3,513,39,3,2,4,921,0,5,926,0,
150,347,5,638,36,4,6,3,1039,0,9,1048,0,
151,491,6,348,60,3,1,3,912,0,5,917,0,
152,340,7,449,15,0,0,0,811,0,2,813,0,
153,330,1,191,84,3,2,0,611,0,5,616,0,
154,212,2,419,16,0,3,0,652,0,1,653,0,
155,322,2,577,77,5,7,8,998,0,7,1005,0,
156,208,3,445,18,2,3,1,680,0,1,681,0,
157,139,2,385,3,1,3,0,533,0,3,536,0,
158,353,4,410,45,1,3,3,819,0,4,823,0,
159,417,11,341,116,1,2,1,889,0,2,891,0,
160,402,9,438,62,1,1,1,914,0,4,918,0,
161,191,4,513,98,3,4,1,814,0,2,816,0,
162,412,6,398,107,2,3,1,929,0,13,942,0,
163,299,5,286,17,2,3,3,615,0,9,624,0,
164,341,15,390,20,2,2,2,772,0,1,773,0,
165,367,14,183,103,2,2,2,673,0,6,679,0,
166,288,2,228,40,0,1,3,562,0,8,570,0,
167,173,3,445,28,4,2,2,657,0,7,664,0,
168,434,10,349,90,3,4,1,891,0,1,892,0,
169,349,6,292,23,1,1,1,673,0,2,675,0,
170,485,12,375,62,2,3,1,940,0,4,944,0,
171,488,5,283,72,1,3,0,852,0,7,859,0,
172,345,5,325,86,4,1,1,767,0,8,775,0,
173,319,8,283,22,2,0,1,635,0,5,640,0,
174,257,5,156,36,0,1,0,455,0,1,456,0,
175,284,6,258,29,2,1,0,580,0,2,582,0,
176,351,7,272,23,2,2,2,659,0,4,663,0,
177,271,20,292,19,1,1,0,604,0,1,605,0,
178,384,6,365,13,2,4,2,776,0,9,785,0,
179,348,7,383,22,1,3,0,764,0,3,767,0,
180,81,3,198,3,0,0,0,285,0,2,287,0,
181,450,10,312,86,4,5,2,869,0,8,877,0,
182,279,6,256,58,2,4,1,606,0,2,608,0,
183,316,6,301,22,3,0,1,649,0,3,652,0,
184,329,2,204,10,0,0,2,547,0,2,549,0,
185,398,4,363,86,0,3,2,856,0,2,858,0,
186,257,7,323,23,2,0,0,612,0,4,616,0,
187,398,12,474,29,1,3,3,920,0,5,925,0,
188,349,2,223,70,1,1,0,646,0,8,654,0,
189,398,8,240,140,2,2,0,790,0,9,799,0,
190,456,10,281,29,1,0,2,779,0,7,786,0,
191,273,2,193,13,0,3,2,486,0,8,494,0,
192,403,8,452,62,3,5,3,936,0,9,945,0,
193,490,8,408,70,2,1,0,979,0,3,982,0,
194,561,43,83,102,4,3,0,796,0,7,803,0,
195,425,7,385,16,1,1,0,835,0,7,842,0,
196,400,7,328,22,2,2,0,761,0,5,766,0,
197,370,7,196,77,1,3,0,654,0,2,656,0,
198,361,16,219,186,0,8,1,791,0,6,797,0,
199,355,8,263,39,1,1,1,668,0,6,674,0,
200,362,8,267,62,0,3,0,702,0,5,707,0,
201,620,6,373,18,1,4,1,1023,0,6,1029,0,
202,360,16,438,123,4,4,0,945,0,5,950,0,
203,293,56,189,121,5,1,0,665,0,1,666,0,
204,341,6,307,20,0,5,2,681,0,3,684,0,
205,335,1,273,16,0,0,0,625,0,8,633,0,
206,277,8,249,9,0,4,3,550,0,3,553,0,
207,471,12,284,12,1,4,0,784,0,6,790,0,
208,530,9,389,17,2,2,0,949,0,6,955,0,
209,338,8,142,13,7,9,7,524,0,6,530,0,
210,394,8,251,35,2,2,1,693,0,2,695,0,
211,346,2,345,13,0,3,2,711,0,2,713,0,
212,578,3,285,22,1,1,0,890,0,5,895,0,
213,212,4,176,4,0,0,0,396,0,3,399,0,
214,366,0,347,59,1,2,1,776,0,2,778,0,
215,232,5,96,11,1,0,0,345,0,4,349,0,
216,240,6,137,87,2,1,0,473,0,3,476,0,
217,848,16,147,83,2,1,2,1099,0,4,1103,0,
218,424,3,354,11,1,0,0,793,0,6,799,0,
219,332,5,244,11,0,0,2,594,0,2,596,0,
220,404,10,215,10,1,5,0,645,0,1,646,0,
221,400,2,345,10,1,1,1,760,0,8,768,0,
222,509,11,491,22,1,2,0,1036,0,2,1038,0,
223,550,1,408,4,0,0,1,954,0,2,966,0,
224,388,11,464,36,0,1,1,901,0,10,911,0,
225,591,141,153,36,0,2,4,927,0,9,936,0,
226,274,3,363,30,2,7,1,680,0,7,687,0,
227,331,11,221,26,2,2,2,595,0,7,602,0,
228,352,10,349,27,2,3,2,745,0,9,754,0,
229,465,7,406,31,1,1,2,913,0,2,915,0,
230,387,3,374,11,0,2,1,778,0,3,781,0,
231,356,8,588,22,1,8,0,983,0,10,993,0,
232,205,5,164,7,0,0,0,381,0,4,385,0,
233,405,23,329,89,2,3,2,853,0,   g,862,0,
234,263,9,275,18,1,2,0,568,0,7,575,0,
235,353,8,384,62,2,4,2,815,0,5,820,0,
236,291,6,148,240,0,0,2,687,0,0,687,0,
237,475,12,368,153,5,1,0,1014,0,5,1019,0,
238,267,8,255,49,2,6,1,588,0,9,597,0,
239,441,4,283,96,3,5,3,835,0,2,837,0,
240,371,7,443,34,5,3,1,864,0,7,871,0,
241,320,10,226,25,3,1,3,588,0,3,591,0,
242,332,12,273,31,4,1,3,662,0,7,669,0,
243,341,11,368,55,3,5,0,783,0,8,791,0,
244,304,23,408,34,5,2,3,779,0,4,783,0,
245,262,3,223,5,1,1,0,495,0,1,496,0,
246,491,7,552,19,4,7,3,1083,0,12,1095,0,
247,297,9,218,20,2,2,1,549,0,10,559,0,
248,328,7,216,4,0,2,3,560,0,6,566,0,
249,337,4,283,16,1,1,3,645,0,5,650,0,
250,444,3,451,14,3,2,8,925,0,6,931,0,
251,254,7,386,29,4,5,1,686,0,3,689,0,
252,269,10,360,10,0,2,0,651,0,4,655,0,
253,285,10,271,44,0,4,2,616,0,7,623,0,
254,361,5,275,20,2,4,2,669,0,8,677,0,
255,   3 IS,14,412,44,2,1,4,792,0,5,797,0,
256,139,2,177,29,1,2,2,352,0,1,353,0,
257,333,16,359,74,5,1,1,789,0,8,797,0,
258,206,10,331,44,3,0,1,595,0,1,596,0,
259,232,11,215,27,1,4,2,492,0,6,498,0,
250,421,5,407,38,2,4,0,877,0,4,881,0,
261,451,39,295,110,3,4,1,903,0,1,904,0,
262,251,4,263,30,1,3,3,555,0,7,562,0,
263,412,7,435,6,2,4,1,867,0,9,876,0,
264,186,9,587,17,3,4,3,809,0,5,814,0,
265,783,19,44,71,0,0,0,917,0,4,921,0,
266,359,10,109,20,0,3,1,502,0,1,503,0,
267,513,21,71,174,2,3,0,784,0,4,788,0,
268,279,19,443,93,5,2,1,842,0,9,851,0,
269,304,5,405,11,2,2,1,730,0,6,736,0,
270,257,22,377,40,1,2,2,701,0,3,704,0,
271,154,11,237,33,1,0,0,436,0,3,439,0,
272,253,4,293,66,1,1,0,618,0,1,619,0,
273,360,17,500,16,0,7,1,901,0,4,905,0,
274,391,33,437,11,0,3,1,876,0,4,880,0,
275,114,4,249,20,1,3,0,391,0,4,395,0,
276,242,1,197,3,3,1,0,447,0,1,448,0,
277,259,42,64,45,0,3,2,415,0,4,419,0,
278,262,19,92,20,0,0,1,394,0,5,399,0,
279,312,15,108,17,3,0,2,457,0,6,463,0,
280,382,9,335,14,0,5,2,747,0,2,749,0,
281,454,16,279,29,0,4,2,784,0,6,790,0,
