of Polling Sijition.1,DILIPCHOSII,BIPLAB UHATTA,MANAS RAN)AN BHIJNIA,RAMKRISHNA SAHKAR,chattapadhyay (SAMBHUNATH CHATTER(EE),ASHOKESARKAR,TUSIIARIANA,RAISINBHA NATII BERA,TAPAS KUMAR KAR,Unnamed: 12,Rejected Volts,NO I A,Total,tendered voles
1,248,13,372,5,1,1,1,2,3,646,0,4,650,0
2,301,16,308,3,3,0,3,1,0,635,0,1,636,0
3,312,3,291,3,0,0,0,1,0,610,0,1,611,0
4,483,12,432,6,2,1,1,2,2,941,0,7,948,0
5,249,25,378,3,1,1,3,7,2,669,0,1,670,0
6,323,28,229,4,5,2,1,4,1,597,0,8,605,0
7,8,342,522,4,3,3,0,2,4,888,0,0,888,0
8,274,6,362,3,0,0,0,3,1,649,0,2,651,0
9,413,22,324,3,2,0,0,2,4,770,0,4,774,0
10,465,7,142,1,1,0,2,1,0,619,0,8,627,0
11,292,16,310,6,6,1,0,0,2,633,0,7,640,0
12,369,48,396,1,6,1,2,2,0,825,0,3,828,0
13,539,15,430,2,6,0,0,4,1,997,0,11,1008,0
14,345,10,346,2,2,0,0,1,1,707,0,2,709,0
15,257,7,413,1,2,1,1,2,3,687,0,3,690,0
16,178,5,243,0,1,1,0,4,0,432,0,0,432,0
17,254,4,157,0,0,0,0,2,1,418,0,3,421,0
18,261,9,248,4,1,0,1,1,0,525,0,2,527,0
19,394,7,390,1,3,2,0,5,0,802,0,7,809,0
20,578,40,378,1,8,1,1,3,1,1011,0,8,1019,0
21,402,40,232,1,1,2,0,3,1,682,0,7,689,0
22,634,26,364,3,6,0,5,9,2,1049,0,7,1056,0
23,515,76,306,2,4,0,1,0,0,904,0,4,908,0
24,533,69,319,3,8,2,3,11,3,951,0,8,959,0
25,338,57,253,2,2,2,0,2,3,659,0,8,667,0
26,501,23,303,1,0,0,0,4,0,832,0,4,836,0
27,392,32,159,2,110,2,1,0,0,698,0,9,707,0
28,427,36,158,0,166,1,2,0,0,790,0,8,798,0
29,536,76,252,1,9,1,2,2,0,879,0,5,884,0
30,383,6,154,0,9,1,4,0,2,559,0,5,564,0
31,256,23,412,2,45,2,5,13,5,763,0,7,770,0
32,171,21,396,9,53,0,1,7,1,659,0,1,660,0
33,233,45,481,4,38,0,5,7,4,817,0,3,820,0
34,509,9,416,2,5,0,0,5,1,947,0,5,952,0
35,245,16,316,2,18,0,0,4,0,601,0,3,604,0
36,529,22,418,3,21,0,1,7,2,1003,0,6,1009,0
37,589,14,325,3,5,2,3,10,3,954,0,7,961,0
38,570,16,307,6,0,0,3,5,4,911,0,10,921,0
39,429,75,188,7,4,2,3,7,5,720,0,11,731,0
40,515,36,166,1,6,5,2,2,1,734,0,11,745,0
41,115,29,464,4,16,1,1,7,1,638,0,4,642,0
42,474,19,187,0,5,1,0,5,1,692,0,10,702,0
43,290,15,215,2,7,1,5,1,0,536,0,5,541,0
44,400,27,160,0,2,0,1,1,0,591,0,4,595,0
45,385,76,357,3,10,3,1,2,3,840,0,4,844,0
46,541,49,330,4,16,1,2,4,0,947,0,15,962,0
47,565,22,314,3,6,0,2,1,1,914,0,10,924,0
48,339,52,605,13,10,2,2,11,5,1039,0,17,1056,0
49,142,14,205,0,2,1,1,3,2,370,0,4,374,0
50,148,148,801,7,8,2,4,9,15,1142,0,4,1146,0
51,475,6,375,2,1,1,0,2,4,866,0,8,874,0
52,281,22,503,4,4,1,2,5,1,823,0,6,829,0
53,242,22,249,2,1,2,3,3,1,525,0,0,525,0
54,513,7,263,1,1,1,0,2,1,789,0,11,800,0
55,332,8,205,1,3,0,3,4,0,556,0,5,561,0
56,371,42,373,1,1,0,0,3,0,791,0,3,794,0
57,328,49,362,2,5,0,2,4,1,753,0,10,763,0
58,523,44,251,0,2,0,1,1,1,823,0,8,831,0
59,256,19,168,2,5,0,1,3,1,455,0,5,460,0
60,654,23,444,5,8,0,0,8,1,1143,0,8,1151,0
61,544,49,328,5,3,3,1,4,4,941,0,13,954,0
62,361,45,306,1,6,0,3,7,2,731,0,3,734,0
63,489,20,491,8,5,1,12,4,1,1031,0,5,1036,0
64,434,28,228,2,1,2,4,1,2,702,0,2,704,0
101,407,8,396,2,3,1,0,4,3,824,0,6,830,0
102,177,123,602,3,83,7,3,10,5,1013,0,5,1018,0
103,412,30,229,2,5,1,0,3,0,682,0,9,691,0
104,290,40,180,0,4,0,1,3,1,519,0,12,531,0
106,459,30,358,0,1,1,4,4,0,857,0,7,864,0
108,505,41,403,2,13,2,1,2,3,972,0,6,978,0
112,581,12,351,4,9,1,1,3,2,964,0,17,981,0
114,331,14,316,3,4,2,2,3,1,676,0,4,680,0
117,474,2,228,4,0,0,20,4,0,732,0,1,,0
118,352,23,274,3,7,0,12,5,1,677,0,11,688,0
121,196,10,219,1,1,1,4,0,2,434,0,5,,0
123,344,6,276,1,2,1,11,5,1,647,0,5,688,0
124,421,10,237,2,9,0,1,3,4,687,0,4,679,0
125,276,54,251,0,2,4,1,2,2,592,0,6,598,0
126,294,18,279,2,2,0,0,2,2,599,0,6,605,0
127,439,25,270,2,8,1,0,1,2,748,0,9,757,0
128,327,34,354,3,12,1,1,3,2,737,0,6,743,0
129,301,48,249,2,5,0,2,2,2,611,0,4,615,0
130,265,27,231,1,3,5,3,1,0,536,0,10,546,0
131,291,51,285,2,1,0,1,3,3,637,0,6,643,0
132,285,56,433,9,7,2,4,10,0,806,0,4,810,0
133,505,92,490,8,7,2,14,6,2,1126,0,9,1135,0
134,460,12,391,4,15,1,2,4,0,889,0,7,896,0
135,360,52,308,1,5,0,1,1,3,731,0,5,736,0
136,304,120,270,4,6,1,0,4,2,711,0,5,716,0
137,550,44,224,2,8,2,1,0,3,834,0,6,840,0
138,150,17,592,7,44,1,0,11,1,823,0,5,828,0
139,275,5,222,3,6,1,1,6,0,519,0,6,525,0
140,526,8,253,3,15,4,2,2,6,819,0,6,825,0
141,218,5,186,2,6,2,1,3,0,423,0,2,425,0
142,24,19,630,7,30,0,2,9,0,721,0,5,726,0
143,491,17,373,4,1,2,2,2,2,894,0,8,902,0
144,520,5,442,3,4,0,1,5,2,982,0,5,987,0
145,585,26,451,6,5,0,1,2,3,1079,0,10,1089,0
146,536,15,362,4,4,1,0,7,4,933,0,11,944,0
147,440,8,229,3,8,1,0,4,1,694,0,2,696,0
148,282,4,353,2,1,1,0,3,0,646,0,0,646,0
149,427,15,349,2,5,0,2,2,0,802,0,3,805,0
150,598,18,441,8,6,1,9,10,3,1094,0,2,1096,0
151,339,10,383,5,2,1,0,6,1,747,0,7,754,0
152,290,2,262,2,0,0,0,0,0,556,0,3,559,0
153,297,7,283,3,1,0,1,3,0,595,0,4,599,0
154,377,11,271,6,3,1,2,5,3,679,0,8,687,0
155,305,7,277,4,1,1,3,7,2,607,0,8,615,0
156,244,9,229,1,1,1,2,2,0,489,0,4,493,0
157,408,34,561,6,2,2,1,4,2,1020,0,12,1032,0
158,402,16,186,3,3,2,1,3,46,662,0,11,673,0
159,244,7,171,3,1,0,0,0,1,427,0,2,429,0
160,600,18,360,4,3,0,0,2,4,991,0,8,999,0
161,390,1,188,5,3,1,0,2,0,590,0,4,594,0
162,305,40,267,1,7,0,0,6,1,627,0,2,629,0
163,198,58,212,2,13,0,0,1,0,484,0,3,487,0
164,319,10,262,5,4,0,0,2,1,603,0,5,608,0
165,310,7,211,2,1,0,2,3,3,539,0,9,548,0
166,272,33,583,4,10,2,5,5,4,918,0,2,920,0
167,18,13,596,8,169,3,1,2,2,812,0,3,815,0
168,13,26,765,3,5,1,2,12,0,827,0,2,829,0
169,8,26,523,2,17,1,2,8,2,589,0,2,591,0
170,28,78,516,5,31,4,2,6,3,673,0,3,676,0
171,12,126,433,1,35,3,1,3,0,614,0,2,616,0
172,192,6,198,2,0,1,1,2,1,403,0,2,405,0
173,320,7,236,1,1,0,0,0,1,566,0,4,570,0
174,269,15,358,0,7,1,0,8,1,659,0,5,664,0
175,173,2,194,2,1,0,0,3,0,375,0,2,377,0
176,622,7,414,1,1,2,1,8,2,1058,0,11,1069,0
177,437,10,375,2,3,2,0,2,0,831,0,0,831,0
178,446,8,456,8,4,0,2,4,1,929,0,2,931,0
179,298,6,242,1,0,1,1,4,0,553,0,1,554,0
180,361,66,457,4,3,1,0,3,2,897,0,2,899,0
181,357,13,346,3,5,0,0,7,1,732,0,8,740,0
182,372,23,352,4,3,1,1,6,3,765,0,9,774,0
183,451,23,206,0,1,1,0,3,0,685,0,4,689,0
184,342,15,399,2,1,1,3,12,1,776,0,8,784,0
185,313,23,350,5,1,0,0,8,0,700,0,3,703,0
186,280,21,305,3,2,0,0,4,0,615,0,4,619,0
187,331,15,280,6,2,0,1,2,1,638,0,7,645,0
188,284,16,259,6,0,2,0,6,0,573,0,6,579,0
189,226,35,315,1,4,0,0,1,1,583,0,8,591,0
190,318,18,368,4,3,1,0,3,1,716,0,4,720,0
191,542,24,302,5,16,1,3,5,0,898,0,13,911,0
192,169,42,222,4,5,1,2,3,1,449,0,2,451,0
193,291,58,326,3,5,0,0,4,0,687,0,7,694,0
194,33,109,543,6,11,2,1,9,2,716,0,0,716,0
195,58,91,594,6,16,4,1,10,3,783,0,4,787,0
196,133,54,514,9,17,7,2,7,3,746,0,5,751,0
197,44,20,491,3,24,1,1,1,1,586,0,1,587,0
198,266,44,429,4,5,1,1,1,2,753,0,1,754,0
199,334,14,314,4,3,1,1,3,1,675,0,3,678,0
200,386,23,388,2,4,2,1,1,0,807,0,7,814,0
201,339,17,318,4,8,3,2,3,1,695,0,2,697,0
202,209,15,133,1,6,0,1,4,0,369,0,4,373,0
203,288,9,233,4,5,2,0,2,0,543,0,3,546,0
204,422,6,297,1,0,0,0,2,2,730,0,6,736,0
205,242,15,161,1,4,0,1,1,0,425,0,4,429,0
206,250,19,297,3,7,0,1,0,1,578,0,4,582,0
207,514,16,481,3,0,1,0,12,2,1029,0,12,1041,0
208,375,11,422,6,2,0,3,3,3,825,0,6,831,0
209,415,17,345,3,4,1,2,1,2,790,0,8,798,0
210,306,12,317,5,2,1,1,1,2,647,0,4,651,0
211,472,8,468,3,1,1,3,2,2,960,0,5,965,0
212,235,1,277,0,8,0,0,5,1,527,0,1,528,0
213,417,8,384,1,4,1,1,1,0,817,0,2,819,0
214,251,11,355,1,3,0,0,0,3,624,0,1,625,0
215,256,31,199,1,5,0,0,0,0,492,0,1,493,0
216,249,4,279,1,2,0,0,1,2,538,0,3,541,0
217,230,2,165,1,0,0,1,4,3,406,0,4,410,0
218,331,32,259,3,1,1,0,2,2,631,0,11,642,0
219,398,32,369,2,2,1,2,2,2,810,0,8,818,0
220,106,8,101,1,0,1,1,0,0,218,0,0,218,0
221,425,43,347,2,1,1,0,4,1,824,0,3,827,0
222,317,15,352,5,3,1,2,2,0,697,0,2,699,0
223,447,11,309,1,6,1,3,3,0,781,0,4,785,0
224,315,2,267,3,6,0,0,4,2,599,0,1,600,0
225,421,12,134,0,2,1,0,0,2,572,0,4,576,0
226,464,14,340,0,1,1,1,4,2,827,0,6,833,0
227,392,22,303,8,3,2,2,9,3,744,0,6,750,0
228,295,1,384,1,3,0,0,4,0,688,0,1,689,0
229,416,14,342,3,7,0,0,0,1,783,0,6,789,0
230,329,4,408,3,0,0,1,4,1,750,0,1,751,0
231,376,31,305,5,2,1,1,4,0,725,0,8,733,0
232,472,13,294,3,3,0,1,1,1,788,0,8,796,0
233,326,3,180,3,7,0,1,0,1,521,0,3,524,0
234,257,24,328,6,101,2,2,12,2,734,0,13,747,0
235,263,18,266,2,7,0,1,2,1,560,0,2,562,0
236,266,12,226,1,3,0,0,1,0,509,0,3,512,0
237,218,4,198,2,1,0,0,3,0,426,0,0,426,0
238,250,4,194,0,8,0,1,3,0,460,0,4,464,0
239,430,3,231,3,6,0,1,4,1,679,0,16,695,0
240,188,20,190,1,3,1,0,4,0,407,0,7,414,0
241,233,41,299,2,2,0,0,0,0,577,0,2,579,0
242,295,11,473,5,12,4,1,8,2,811,0,8,819,0
243,424,36,461,8,9,2,5,5,3,953,0,10,963,0
244,296,5,173,1,1,0,0,3,0,479,0,1,480,0
245,476,12,455,6,0,1,1,2,0,953,0,9,962,0
246,276,0,325,5,4,0,0,4,1,615,0,9,624,0
247,364,5,301,2,2,0,0,2,2,678,0,4,682,0
248,274,21,194,3,2,1,0,1,0,496,0,0,496,0
249,203,10,287,1,2,1,1,2,1,508,0,3,511,0
250,202,4,221,3,5,0,1,1,2,439,0,2,441,0
251,284,4,291,6,2,0,1,4,0,592,0,3,595,0
252,643,4,417,2,3,1,0,4,1,1075,0,7,1082,0
253,488,9,231,1,11,1,1,3,2,747,0,6,753,0
254,286,5,416,3,2,0,2,0,1,715,0,5,720,0
255,412,13,225,6,8,0,1,7,5,677,0,9,686,0
256,482,19,331,2,6,4,1,2,3,850,0,7,857,0
257,614,18,361,2,0,1,2,2,1,1001,0,5,1006,0
258,375,15,111,3,0,0,1,1,1,507,0,2,509,0
259,371,16,246,1,2,0,2,3,0,641,0,9,650,0
260,578,43,435,3,7,1,3,5,7,1082,0,16,1098,0
261,486,37,469,8,1,4,3,11,5,1024,0,11,1035,0
262,251,23,302,2,2,0,1,6,0,587,0,3,590,0
263,400,109,595,2,2,1,1,6,9,1125,0,7,1132,0
264,412,88,446,0,6,5,3,3,1,964,0,2,966,0
265,353,38,343,8,4,1,6,4,2,759,0,1,760,0
266,479,14,487,7,12,3,10,4,3,1019,0,7,1026,0
267,381,36,302,5,3,2,17,1,1,748,0,4,752,0
268,354,82,513,2,14,0,46,1,1,1013,0,5,1018,0
269,412,24,453,3,5,0,1,5,3,906,0,4,910,0
270,440,12,440,4,5,0,2,5,2,910,0,7,917,0
271,336,6,292,6,2,0,1,6,3,652,0,0,652,0
272,238,8,347,3,3,1,0,5,0,605,0,8,613,0
273,412,19,285,2,0,0,1,3,1,723,0,5,728,0
274,394,43,273,2,4,1,2,2,2,723,0,1,724,0
275,549,36,333,1,7,0,4,8,4,942,0,14,956,0
276,272,238,193,4,3,2,1,2,6,721,0,4,725,0
277,459,17,451,9,1,5,1,1,0,944,0,8,952,0
278,562,105,364,6,13,1,2,4,2,1059,0,15,1074,0
279,443,26,288,6,2,3,0,0,5,773,0,9,782,0
280,404,10,225,2,1,1,1,4,1,649,0,7,656,0
281,410,38,343,0,4,1,1,4,2,803,0,14,817,0
282,520,25,333,1,6,1,2,5,3,896,0,4,900,0
283,476,38,334,2,3,0,2,1,1,857,0,3,860,0
284,552,35,228,2,8,1,4,3,2,835,0,15,850,0
286,394,11,344,1,1,0,0,1,2,754,0,5,759,0
287,276,8,201,4,5,0,1,0,0,495,0,4,499,0
288,478,19,366,2,6,0,2,8,0,881,0,8,889,0
292,284,9,325,3,1,0,2,6,0,630,0,2,632,0
294,284,7,354,4,1,0,0,3,0,653,0,5,,0
296,387,24,413,8,3,0,1,8,1,845,0,8,853,0
298,400,11,514,4,15,1,1,8,2,956,0,12,968,0
299,638,8,259,5,5,0,1,3,1,,0,16,936,0
300,425,71,392,0,7,1,2,1,0,899,0,4,903,0
301,460,29,479,3,3,2,1,5,2,984,0,17,1001,0
302,334,17,264,2,6,0,2,2,2,629,0,7,636,0
303,272,27,227,0,8,0,2,3,2,541,0,2,543,0
304,328,21,258,2,0,4,0,7,0,620,0,4,624,0
1,2,3,4,5,6,7,8,9,10,11,12,13,14,15
31,264,8,143,1,0,0,0,3,2,421,0,3,424,0
32,375,18,238,3,1,2,29,1,1,668,0,6,674,0
33,310,11,260,1,0,0,15,2,2,601,0,8,609,0
34,487,11,386,11,9,1,2,4,0,911,0,11,922,0
35,224,10,248,2,0,0,0,5,3,492,0,0,492,0
36,237,23,656,3,2,1,3,8,0,933,0,0,933,0
37,238,14,171,2,1,1,7,4,1,439,0,5,444,0
38,344,9,221,0,3,0,1,0,1,579,0,3,582,0
39,783,11,320,8,3,2,2,6,3,1138,0,9,1147,0
40,432,28,481,4,7,4,5,8,2,971,0,6,977,0
41,333,10,223,5,0,0,4,2,1,578,0,3,581,0
42,317,79,178,2,2,1,1,0,0,580,0,3,583,0
43,265,30,334,4,1,1,1,1,0,637,0,4,641,0
44,84,35,550,7,10,1,2,5,1,695,0,4,699,0
45,152,24,245,3,9,5,1,4,3,446,0,12,458,0
46,15,31,679,8,11,4,3,2,2,755,0,3,758,0
47,14,25,617,8,4,4,2,0,0,674,0,3,677,0
48,103,39,878,6,7,1,1,9,0,1044,0,4,1048,0
49,6,15,457,1,4,0,0,0,0,483,0,0,483,0
50,269,49,767,7,15,0,0,3,2,1112,0,3,1115,0
51,634,43,295,3,2,0,1,6,0,984,0,6,990,0
52,358,9,270,2,1,3,5,1,1,650,0,2,652,0
53,10,9,617,3,8,1,0,1,0,649,0,2,651,0
54,11,16,577,2,3,2,1,2,0,614,0,2,616,0
55,344,20,182,1,1,0,1,3,4,556,0,6,562,0
56,323,17,176,2,1,0,0,2,0,521,0,1,522,0
57,347,11,179,2,0,0,1,0,1,541,0,3,544,0
58,499,6,128,4,5,0,3,0,0,645,0,4,649,0
59,417,39,233,1,3,2,2,4,3,704,0,7,711,0
60,305,50,186,1,6,1,3,1,4,557,0,8,565,0
61,356,53,115,1,1,2,0,2,3,533,0,2,535,0
62,409,21,352,2,4,0,0,3,2,793,0,3,796,0
63,418,15,279,3,0,1,0,3,2,721,0,5,726,0
64,302,38,395,2,8,2,1,5,0,753,0,3,756,0
65,433,26,412,3,4,0,1,1,1,881,0,6,887,0
66,443,77,425,6,20,2,5,1,5,984,0,8,992,0
67,444,69,373,4,8,1,1,6,1,907,0,13,920,0
68,344,46,374,3,2,1,1,4,5,780,0,9,789,0
69,215,231,322,5,6,1,0,5,3,788,0,2,790,0
70,533,37,496,6,1,1,2,2,2,1080,0,6,1086,0
71,138,7,226,0,1,0,0,0,2,374,0,1,375,0
72,570,63,349,5,4,2,2,1,1,997,0,8,1005,0
73,512,74,451,7,7,1,3,3,0,1058,0,6,1064,0
74,165,22,213,2,2,0,3,4,1,412,0,1,413,0
75,149,136,145,0,11,0,1,1,0,443,0,1,444,0
76,347,83,382,2,3,0,1,2,0,820,0,0,820,0
77,147,67,342,3,4,0,2,1,1,567,0,1,568,0
78,331,82,303,4,5,1,0,0,1,727,0,6,733,0
79,162,50,289,0,6,0,0,3,1,511,0,3,514,0
80,278,39,275,5,3,0,2,3,3,608,0,4,612,0
81,300,32,306,9,4,3,1,5,2,662,0,1,663,1
82,279,18,252,3,5,2,2,1,1,563,0,10,573,0
83,492,50,476,4,3,0,4,5,4,1038,0,12,1050,0
84,628,45,373,8,7,2,5,3,2,1073,0,6,1079,0
85,353,8,295,1,4,0,1,0,1,663,0,6,669,0
86,302,16,269,3,4,0,6,2,0,602,0,3,605,0
87,491,16,416,3,3,0,0,1,0,930,0,4,934,0
88,242,4,189,1,0,0,7,0,0,443,0,1,444,0
89,395,16,418,3,3,1,9,2,4,851,0,7,858,0
90,234,41,399,5,9,1,26,4,4,723,0,5,728,0
91,310,4,258,4,3,2,7,3,0,591,0,1,592,0
92,455,47,417,5,9,2,74,4,1,1014,0,6,1020,0
93,412,29,348,4,3,0,1,3,2,802,0,7,809,0
94,338,71,478,5,4,3,1,5,3,908,0,7,915,0
95,357,97,300,2,6,1,2,4,0,769,0,4,773,0
96,302,41,330,7,2,1,1,6,2,692,0,7,699,0
97,537,47,520,4,2,0,0,3,2,1115,0,8,1123,0
98,384,24,162,2,5,0,2,0,0,579,0,4,583,0
99,451,15,439,2,4,2,5,5,2,925,0,8,933,0
100,423,10,431,4,0,0,0,6,1,875,0,7,882,0
101,308,51,235,1,2,1,3,0,1,602,0,4,606,0
102,252,12,210,2,1,2,4,1,1,485,0,2,487,0
103,316,19,288,4,3,1,3,3,2,639,0,8,647,0
104,326,2,217,0,1,1,2,0,0,549,0,1,550,0
105,314,6,217,1,2,1,1,3,1,546,0,3,649,0
106,257,11,210,2,1,0,2,0,2,485,0,4,489,0
107,467,3,328,3,3,2,2,2,7,817,0,2,819,0
108,434,7,459,2,4,1,3,4,2,916,0,1,917,0
109,181,12,234,2,0,0,4,0,0,433,0,0,433,0
110,293,9,285,3,4,4,3,9,1,611,0,5,616,0
111,416,19,314,4,3,1,4,2,2,765,0,5,770,0
112,400,19,387,3,1,1,8,7,0,826,0,9,835,0
113,200,3,170,2,1,1,1,0,0,378,0,1,379,0
114,514,9,445,3,2,1,10,7,1,992,0,3,995,0
115,185,6,144,1,1,0,0,3,0,340,0,3,343,0
116,153,2,155,0,0,1,1,1,0,313,0,1,314,0
117,371,24,362,5,5,4,3,4,0,778,0,6,784,1
118,311,4,162,2,2,1,1,2,0,485,0,2,487,0
119,68,33,554,2,3,1,4,1,2,668,0,4,672,0
120,189,38,243,9,3,2,1,4,1,490,0,3,493,0
121,434,18,433,2,0,3,3,12,4,909,0,13,922,0
122,226,14,295,0,4,3,0,6,2,550,0,5,555,0
123,491,30,394,6,10,3,40,3,1,978,0,6,984,0
124,251,13,364,6,3,0,3,5,0,645,0,4,649,0
125,356,25,304,3,2,3,3,4,4,704,0,9,713,0
126,410,25,263,4,0,1,28,1,1,733,0,5,738,0
127,231,9,169,2,3,0,46,2,1,463,0,3,466,0
128,388,8,348,3,2,3,3,3,1,759,0,5,764,0
129,405,32,401,3,7,1,1,1,3,854,0,12,866,0
130,314,48,377,6,7,1,4,6,4,767,0,10,777,0
131,255,13,353,3,3,0,6,15,0,648,0,8,656,0
132,633,36,187,5,7,2,6,7,3,886,0,19,905,0
133,515,13,84,3,5,0,0,5,1,626,0,8,634,0
134,384,9,152,1,1,0,2,2,1,552,0,2,554,0
135,222,9,106,0,0,0,2,1,4,344,0,2,346,0
136,457,26,227,1,4,3,6,12,2,738,0,14,752,0
137,460,32,209,1,2,2,1,8,5,720,0,8,728,0
138,217,4,193,1,4,0,0,2,1,422,0,4,426,0
139,213,26,358,11,11,2,1,8,4,634,0,6,640,0
140,518,40,312,6,10,1,4,17,6,914,0,15,929,0
141,295,19,237,5,16,1,1,9,3,586,0,9,595,0
142,293,6,90,1,0,1,1,1,0,393,0,6,399,0
143,875,20,150,6,2,4,4,9,6,1076,0,27,1103,0
144,597,13,101,2,1,4,3,9,1,731,0,18,749,0
145,621,19,227,2,1,0,4,3,2,879,0,9,888,0
146,377,10,407,0,1,1,2,4,4,806,0,4,810,0
147,488,17,316,2,1,0,1,10,6,841,0,18,859,0
148,561,11,422,5,3,1,3,12,4,1022,0,10,1032,0
149,203,8,93,2,1,0,0,5,1,313,0,5,318,0
150,263,5,154,2,3,3,0,2,2,434,0,2,436,0
151,598,14,466,2,4,1,2,7,1,1095,0,11,1106,0
152,372,7,278,0,2,0,2,1,0,662,0,5,667,0
153,409,9,274,3,8,2,4,5,2,716,0,7,723,0
154,556,17,360,5,4,3,1,10,1,957,0,16,973,0
155,471,17,349,4,7,0,4,7,6,865,0,12,877,0
156,425,15,407,2,5,1,2,18,1,876,0,14,890,0
157,461,8,355,6,1,3,0,4,1,839,0,9,848,0
158,224,4,279,2,0,0,0,6,0,515,0,8,523,0
159,316,12,320,2,2,0,1,1,1,655,0,6,661,0
160,526,5,345,1,6,1,1,5,1,891,0,8,899,0
161,328,18,348,0,3,0,1,3,1,702,0,8,710,0
162,535,13,400,11,6,0,2,5,3,975,0,9,984,0
163,198,7,662,9,4,0,3,10,1,894,0,11,905,0
164,39,24,708,4,1,1,1,17,0,795,0,5,800,0
165,38,2,459,1,1,1,1,4,1,508,0,1,509,0
166,73,6,704,9,10,2,0,13,3,820,0,11,831,0
167,631,17,356,5,3,0,1,1,0,1014,0,14,1028,0
168,295,10,185,1,0,0,0,1,2,494,0,8,502,0
169,208,3,187,0,1,0,0,2,0,401,0,1,402,0
170,519,3,351,3,4,1,1,3,1,886,0,4,890,0
171,399,9,482,2,7,0,1,9,1,910,0,8,918,0
172,108,4,414,4,3,0,0,7,1,541,0,2,543,0
173,141,9,418,2,5,0,0,4,0,579,0,2,581,0
174,455,11,406,5,3,3,6,20,2,911,0,11,922,0
175,166,3,229,3,0,0,0,3,1,405,0,1,406,0
176,410,19,240,1,1,0,0,5,2,678,0,7,685,0
177,500,14,534,9,2,1,3,6,1,1070,0,8,1078,0
178,386,12,498,8,2,3,0,4,0,913,0,4,917,0
179,393,12,406,1,3,1,1,17,1,835,0,5,840,0
180,588,4,447,3,0,1,3,10,3,1059,0,7,1066,0
181,219,5,277,2,0,0,1,4,0,508,0,6,514,0
182,475,10,142,4,1,0,2,2,1,637,0,8,645,0
183,110,2,73,0,2,0,0,2,0,189,0,0,189,0
184,474,25,408,3,1,0,2,9,4,926,0,12,938,0
185,211,81,502,3,14,0,0,8,3,822,0,8,830,0
186,556,11,218,3,5,0,0,4,0,797,0,11,808,0
187,135,55,251,3,8,2,1,5,3,463,0,8,471,0
188,366,9,306,1,3,0,1,2,25,713,0,6,719,0
189,360,9,251,2,1,1,3,7,7,641,0,12,653,0
190,529,24,235,1,2,2,0,5,5,803,0,12,815,0
191,422,13,210,2,3,1,1,3,2,657,0,4,661,0
192,339,15,247,3,1,1,1,6,3,616,0,5,621,0
193,512,18,253,4,7,3,1,7,4,807,0,7,814,0
194,270,11,231,2,3,0,3,3,0,523,0,6,529,0
195,194,2,179,0,1,0,2,2,0,380,0,2,382,0
196,266,15,253,1,1,0,0,1,1,538,0,3,541,0
197,440,38,467,1,4,0,5,8,1,964,0,6,970,0
198,361,12,391,0,0,0,1,7,1,773,0,6,779,0
199,478,10,282,3,3,0,1,4,2,783,0,5,788,1
200,400,15,259,0,3,1,2,8,4,692,0,6,698,1
201,375,9,115,1,1,1,1,1,4,508,0,5,513,0
202,386,6,366,1,1,0,2,7,1,770,0,5,775,0
203,306,24,433,3,5,0,1,7,0,779,0,4,783,0
204,247,8,170,1,5,2,1,3,0,437,0,4,441,0
205,378,6,205,0,1,0,3,1,0,594,0,6,600,0
206,249,3,92,1,6,2,1,4,2,360,0,4,364,0
207,510,13,319,6,4,2,0,5,1,860,0,17,877,0
208,581,29,357,3,4,5,2,5,4,990,0,13,1003,0
209,166,17,165,0,3,4,2,5,0,362,0,6,368,0
210,636,34,179,4,4,1,1,2,1,862,0,8,870,0
211,474,32,278,4,4,1,1,2,4,800,0,15,815,0
212,217,5,217,2,2,0,1,4,0,        44S,0,2,450,0
213,243,19,183,1,4,0,2,2,1,455,0,3,458,0
214,487,22,89,0,0,0,2,1,5,606,0,10,616,0
215,323,29,200,2,2,0,0,6,1,563,0,      a,571,0
216,314,27,170,1,0,2,0,1,1,516,0,8,524,0
217,159,14,59,0,1,0,1,1,0,235,0,2,237,0
218,379,16,236,1,1,2,0,3,0,638,0,7,645,0
219,578,9,218,2,0,1,2,4,0,814,0,9,823,0
220,408,8,257,6,4,0,2,7,1,693,0,10,703,0
221,185,3,100,2,1,0,1,2,0,294,0,4,298,0
222,223,8,142,4,0,0,1,1,0,379,0,5,384,0
223,549,16,215,4,4,0,0,4,2,794,0,15,809,0
224,615,22,259,2,5,3,6,3,4,919,0,13,932,0
225,316,5,308,4,5,1,0,9,0,648,0,4,652,0
226,284,5,154,2,3,0,2,3,6,459,0,8,467,0
227,190,2,317,1,1,0,0,1,0,512,0,4,516,0
228,406,15,301,2,5,1,1,0,0,731,0,9,740,0
229,209,3,174,1,0,0,0,5,1,393,0,6,399,0
230,183,3,131,1,2,0,1,0,1,322,0,1,323,0
231,470,7,433,2,2,0,0,9,0,923,0,9,932,0
232,471,17,379,2,2,1,2,6,1,881,0,6,887,0
233,183,16,310,1,1,0,0,3,0,514,0,2,516,0
234,384,20,428,3,0,1,0,3,1,840,0,2,842,0
235,169,5,139,2,0,0,1,2,0,318,0,0,318,0
236,421,12,368,0,4,0,1,3,1,810,0,6,816,0
237,362,14,297,2,1,0,2,1,0,679,0,13,692,0
238,298,13,271,3,4,0,0,1,1,591,0,4,595,0
239,178,7,136,1,0,0,0,1,0,323,0,1,324,0
240,567,44,423,5,3,0,1,6,1,1050,0,9,1059,0
241,211,4,231,4,0,2,1,5,0,458,0,3,461,0
242,378,11,388,1,0,2,0,3,2,785,0,3,788,0
243,261,15,212,0,1,0,1,2,1,493,0,1,494,0
244,359,6,354,1,18,0,0,4,2,744,0,2,746,0
245,274,6,234,3,2,0,1,3,0,523,0,3,526,0
246,435,19,263,2,6,2,2,6,2,737,0,11,748,0
247,177,1,168,2,1,0,0,0,1,350,0,1,351,0
248,333,7,321,2,0,0,0,4,0,667,0,5,672,0
249,323,42,561,6,8,2,1,5,2,950,0,10,960,0
250,274,17,295,2,1,1,2,3,2,597,0,5,602,0
251,477,10,234,2,5,1,1,2,1,733,0,16,749,0
252,214,5,223,2,1,0,1,3,0,449,0,0,449,0
253,422,30,552,10,2,4,2,7,4,1033,0,7,1040,0
254,472,21,507,12,7,3,4,15,3,1044,0,12,1056,0
255,271,31,336,10,4,0,1,5,5,663,0,5,668,0
256,169,7,344,4,2,0,0,4,2,532,0,5,537,0
257,374,76,372,8,1,2,1,6,2,842,0,6,848,0
258,174,9,151,0,1,1,2,1,2,        ?41,0,4,345,0
259,306,12,649,2,3,0,2,2,2,978,0,8,986,0
260,481,10,483,4,3,2,1,4,1,989,0,4,993,0
261,402,10,513,3,3,0,0,6,0,937,0,11,948,0
262,331,18,448,6,3,1,1,10,6,824,0,10,834,0
263,301,11,358,4,1,1,3,6,0,685,0,3,688,0
264,238,5,209,3,1,1,0,3,2,462,0,5,467,0
265,387,14,598,3,1,2,0,4,1,1010,0,2,1012,0
266,326,6,445,1,0,0,0,2,2,782,0,3,785,0
267,126,11,159,2,0,1,0,9,2,310,0,3,313,0
268,403,11,277,3,0,0,10,2,0,706,0,2,708,0
269,261,19,302,1,0,2,0,5,3,593,0,5,598,0
270,155,5,339,2,0,1,0,9,0,511,0,3,514,0
271,359,10,499,9,3,0,3,6,3,892,0,6,898,0
1,642,20,342,14,9,3,3,12,13,1058,0,21,1079,0
2,205,8,245,4,3,1,1,3,1,471,0,2,473,0
3,623,38,393,5,13,7,3,21,5,1108,0,19,1127,0
4,409,22,396,0,3,5,1,7,3,846,0,1,847,0
5,243,23,137,0,2,3,0,0,3,411,0,5,416,0
6,460,40,561,13,16,5,8,8,4,1115,0,18,1133,0
7,346,10,393,4,2,0,2,2,0,759,0,7,766,0
8,649,20,436,8,3,2,2,5,4,1129,0,20,1149,0
9,498,24,342,10,2,1,3,5,4,889,0,10,899,0
10,300,35,423,10,2,2,2,1,1,776,0,9,785,0
11,207,8,276,4,4,1,3,1,2,506,0,7,513,0
12,545,113,301,10,10,3,4,9,4,999,0,11,1010,0
13,267,7,181,1,6,1,0,0,1,464,0,7,471,0
14,251,20,257,7,2,7,6,16,1,567,0,7,574,0
15,304,63,171,6,5,2,1,4,0,556,0,10,566,0
16,412,38,261,4,24,1,5,8,3,756,0,12,768,0
17,335,31,160,1,9,2,0,3,1,542,0,7,549,0
18,488,23,420,3,5,1,5,4,0,949,0,12,961,0
19,284,26,137,1,4,0,0,1,1,454,0,5,459,0
20,106,261,275,3,26,2,0,3,5,681,0,6,687,0
21,165,29,209,2,5,0,1,0,1,412,0,0,412,0
22,392,52,361,6,8,0,1,4,2,826,0,6,832,0
23,238,31,139,1,2,1,2,1,3,418,0,10,428,0
24,591,95,370,9,9,7,8,7,11,1107,0,9,1116,0
25,520,14,489,7,5,3,7,5,3,1053,0,17,1070,0
26,268,41,293,4,6,2,10,4,0,628,0,3,631,0
27,230,108,444,6,2,1,0,4,1,796,0,4,800,0
28,293,20,436,5,2,0,1,3,2,762,0,5,767,0
29,505,8,266,3,2,0,2,6,1,793,0,10,803,0
30,261,11,379,4,3,3,1,13,3,678,0,9,687,0
31,96,31,430,7,4,0,2,3,2,575,0,6,581,0
32,654,52,429,4,6,2,4,3,2,1156,0,12,1168,0
33,356,23,310,3,3,0,1,3,0,699,0,4,703,0
34,303,74,216,4,4,7,2,6,6,622,0,5,627,0
35,706,61,311,4,1,3,4,7,4,1101,0,11,1112,0
36,342,22,150,1,3,0,3,4,3,528,0,5,533,0
37,486,39,490,11,5,3,3,3,6,1046,0,11,1057,0
38,594,155,150,20,11,9,5,6,7,957,0,14,971,0
39,357,47,360,5,11,4,4,4,6,798,0,6,804,0
40,254,28,82,1,2,2,1,2,1,373,0,6,379,0
41,385,57,335,3,3,0,1,4,8,796,0,19,815,0
42,392,16,209,3,3,1,0,2,0,626,0,3,629,0
43,405,72,413,11,10,8,4,15,6,944,0,19,963,0
44,215,21,212,4,2,3,1,3,0,461,0,6,467,0
45,580,42,261,9,6,5,2,5,1,911,0,17,928,0
46,169,6,168,1,0,0,0,5,2,351,0,3,354,0
47,419,40,332,13,15,3,4,6,9,841,0,18,859,0
48,223,17,128,2,0,4,0,1,0,375,0,3,378,0
49,358,66,379,10,17,2,2,10,2,846,0,14,860,0
50,457,46,322,7,11,6,3,5,7,864,0,20,884,0
51,263,27,111,3,2,0,0,1,0,407,0,6,413,0
52,318,27,218,4,6,6,0,3,2,584,0,8,592,0
53,306,45,310,9,12,3,1,4,5,695,0,13,708,0
54,634,49,410,14,8,4,6,12,10,1147,0,22,1169,0
55,313,13,212,1,3,1,3,6,3,555,0,10,565,0
56,311,36,241,5,8,2,5,2,1,611,0,5,616,0
57,323,27,198,6,6,2,1,7,5,575,0,11,586,0
58,391,11,215,2,6,2,3,5,2,637,0,8,645,0
59,259,12,129,0,6,2,0,3,2,413,0,6,419,0
60,355,14,368,2,3,1,1,5,1,750,0,3,753,0
61,238,23,214,2,3,1,1,0,2,484,0,6,490,0
62,582,18,304,11,6,6,8,9,3,947,0,13,960,0
63,241,18,137,6,2,3,1,3,2,413,0,9,422,0
64,657,26,315,1,7,1,0,5,2,1014,0,10,1024,0
65,499,36,112,3,8,3,2,7,0,670,0,11,681,0
66,456,35,221,3,4,4,3,4,3,733,0,11,744,0
67,275,17,176,7,6,3,1,4,2,491,0,2,493,0
68,579,17,340,5,4,4,2,48,5,1004,0,8,1012,0
69,448,28,406,4,6,2,1,3,3,901,0,5,906,0
70,212,3,182,1,1,2,2,1,1,405,0,7,412,0
71,399,13,279,10,5,0,0,5,4,715,0,7,722,0
72,316,13,215,6,5,0,4,4,3,566,0,8,574,0
73,727,65,258,5,15,3,3,3,6,1085,0,28,1113,0
74,263,8,250,1,3,0,3,1,1,530,0,1,531,0
75,496,39,357,4,9,6,3,13,5,932,0,19,951,0
76,568,34,396,6,2,3,5,6,6,1026,0,13,1039,0
77,504,9,317,8,4,0,2,3,1,848,0,6,854,0
78,534,17,276,2,2,0,0,7,2,840,0,12,852,0
79,689,32,285,11,4,0,3,4,1,1029,0,15,1044,0
80,601,20,199,2,6,2,4,2,2,838,0,13,851,0
81,693,46,261,9,10,7,12,2,4,1044,0,12,1056,0
82,445,15,217,0,7,2,1,0,2,689,0,9,698,0
83,433,64,330,2,3,1,13,5,0,851,0,5,856,0
84,384,82,419,6,8,2,23,1,3,928,0,4,932,0
85,614,16,322,9,7,1,0,4,1,974,0,15,989,0
86,425,25,391,0,8,0,1,1,0,851,0,4,855,0
87,330,86,156,11,4,1,1,3,5,597,0,11,608,0
88,270,54,184,2,5,4,4,5,1,529,0,6,535,0
89,439,18,223,3,3,3,0,3,3,695,0,6,701,0
90,405,36,411,4,15,3,4,10,4,892,0,6,898,1
91,322,49,198,1,9,1,3,5,1,589,0,8,597,0
92,275,14,116,4,5,1,1,3,1,420,0,6,426,0
93,441,130,354,6,7,5,4,6,13,966,0,23,989,0
94,691,71,328,10,12,2,3,14,8,1139,0,21,1160,0
95,200,15,157,3,1,0,1,1,0,378,0,2,380,0
96,207,28,195,3,15,1,2,4,4,459,0,5,464,0
97,584,35,216,4,10,3,5,1,0,858,0,13,871,0
98,545,69,406,13,12,7,5,8,8,1073,0,29,1102,0
99,757,74,230,5,11,2,0,3,4,1086,0,15,1101,0
100,507,48,213,5,5,3,3,4,5,793,0,9,802,0
101,352,38,331,6,2,1,5,11,2,748,0,11,759,0
102,438,38,326,2,8,3,1,3,3,822,0,19,841,0
103,457,50,206,0,7,0,3,3,2,728,0,12,740,0
104,276,19,162,3,4,1,0,1,1,467,0,4,471,0
105,353,76,239,3,28,2,3,3,4,711,0,11,722,0
106,453,13,238,0,3,2,5,1,0,715,0,6,721,0
107,324,9,205,3,3,4,1,2,0,551,0,7,558,0
108,478,45,280,5,2,2,4,0,3,819,0,11,830,0
109,393,23,224,5,12,2,4,6,1,670,0,5,675,0
110,817,17,240,4,8,4,1,4,3,1098,0,5,1103,0
111,407,17,206,2,3,1,2,4,1,643,0,2,645,0
112,446,35,270,6,16,1,10,0,1,785,0,6,791,0
113,562,27,208,5,6,4,1,6,2,821,0,13,834,0
114,370,8,144,4,3,0,2,1,0,532,0,5,537,0
115,435,20,244,6,1,2,1,0,0,709,0,11,720,0
116,599,22,367,15,7,3,6,2,4,1025,0,10,1035,0
117,204,4,132,1,0,0,1,2,0,344,0,2,346,0
118,224,20,120,2,8,1,1,1,0,377,0,8,385,0
119,422,19,196,0,3,0,6,1,4,651,0,4,655,0
120,639,36,272,5,10,2,3,4,2,973,0,21,994,0
121,258,5,112,5,3,2,1,0,1,387,0,3,390,0
122,575,57,187,4,6,4,6,3,1,843,0,12,855,0
123,535,62,312,2,6,3,1,3,2,926,0,10,936,0
124,242,15,97,3,2,0,0,0,0,359,0,4,363,0
125,515,66,225,5,3,0,2,3,2,821,0,11,832,0
126,190,39,174,2,2,0,1,1,0,409,0,4,413,0
127,475,157,375,6,10,1,8,5,2,1039,0,5,1044,0
128,397,27,280,4,9,1,10,3,3,734,0,7,741,0
129,608,44,313,9,13,3,4,3,4,1001,0,19,1020,0
130,361,67,320,8,6,5,0,1,4,772,0,5,777,0
131,325,45,41,8,1,2,0,0,3,425,0,6,431,0
132,508,57,172,2,11,1,10,4,4,769,0,10,779,0
133,516,41,315,34,11,1,5,5,1,929,0,10,939,0
134,452,39,157,9,6,0,4,2,1,670,0,5,675,0
135,436,187,283,8,5,6,105,6,10,1046,0,25,1071,0
136,242,13,166,2,5,1,1,0,1,431,0,3,434,0
137,400,14,328,6,7,1,3,1,3,763,0,6,769,0
138,419,26,394,10,5,4,2,5,6,871,0,14,885,0
139,335,5,255,6,2,1,3,4,2,613,0,7,620,0
140,163,3,292,0,2,2,1,2,0,465,0,7,472,0
141,358,2,272,2,2,1,0,11,0,648,0,10,658,0
142,421,12,550,11,1,1,1,3,4,1004,0,7,1011,0
143,131,5,262,0,2,0,1,0,1,402,0,7,409,0
144,381,15,642,10,4,0,2,6,1,1061,0,13,1074,0
145,339,11,458,7,3,1,1,1,8,829,0,8,837,0
146,432,20,438,4,6,4,2,11,0,917,0,9,926,0
147,168,16,533,5,0,0,1,0,2,725,0,4,729,0
148,157,10,330,2,9,1,3,3,0,515,0,2,517,0
149,318,20,457,6,2,0,1,1,2,807,0,12,819,0
150,269,12,439,4,1,1,3,3,2,734,0,13,747,0
151,176,10,289,2,2,0,0,2,1,482,0,3,485,0
152,196,12,326,2,4,1,3,5,1,550,0,3,553,0
153,287,17,314,4,3,2,11,5,1,644,0,2,646,0
154,366,16,433,6,4,2,2,9,3,841,0,3,844,0
155,314,5,300,1,1,0,0,1,0,622,0,5,627,0
156,277,4,379,7,0,0,0,0,0,667,0,3,670,0
157,415,16,501,4,4,3,0,3,2,948,0,11,959,0
158,230,24,515,6,2,2,0,3,1,783,0,6,789,0
159,372,56,673,14,6,4,6,5,1,1137,0,11,1148,0
160,244,4,328,4,1,0,2,1,0,584,0,2,586,0
161,386,20,737,17,5,2,1,0,2,1170,0,12,1182,0
162,223,0,501,3,1,1,0,4,1,734,0,6,740,0
163,296,7,527,5,5,1,4,7,2,854,0,9,863,0
164,286,6,403,2,1,3,2,2,0,705,0,10,715,0
165,449,21,668,22,13,7,5,7,8,1200,0,8,1208,0
166,389,8,509,15,0,1,2,9,2,935,0,7,942,0
167,240,8,414,10,2,2,1,4,4,685,0,6,691,0
168,181,15,433,6,5,0,3,3,0,646,0,6,652,0
169,206,4,592,2,2,1,2,9,0,818,0,6,824,0
170,216,12,463,4,3,0,1,6,1,706,0,5,711,0
171,179,3,430,5,2,0,0,3,2,624,0,4,628,0
172,370,29,481,5,4,1,0,2,2,894,0,8,902,0
173,239,35,426,6,2,1,0,5,1,715,0,6,721,0
174,220,25,411,3,3,0,0,2,1,665,0,9,674,0
175,357,13,369,4,10,3,3,4,1,764,0,6,770,0
176,481,32,503,8,3,1,3,1,2,1034,0,10,1044,0
177,410,27,515,1,6,2,0,4,2,967,0,7,974,0
178,225,24,245,3,2,0,0,4,1,504,0,5,509,0
179,372,28,584,10,3,2,3,3,4,1009,0,1,1010,0
180,486,22,410,10,7,2,2,4,7,950,0,11,961,0
181,472,24,616,8,4,0,5,7,4,1140,0,5,1145,0
182,362,21,529,7,3,0,1,4,2,929,0,7,936,0
183,451,15,629,6,2,0,4,2,4,1113,0,3,1116,0
184,491,17,424,11,1,1,2,7,4,958,0,13,971,0
185,251,119,371,5,5,4,1,3,3,762,0,5,767,0
186,297,8,296,2,1,2,1,1,2,610,0,7,617,0
187,214,7,248,2,0,2,1,2,1,477,0,4,481,0
188,490,19,421,6,0,0,1,8,1,946,0,11,957,0
189,316,4,374,5,3,1,2,4,2,711,0,8,719,0
190,366,17,192,2,2,0,2,4,1,586,0,6,592,0
191,408,29,187,1,1,2,0,4,3,635,0,6,641,0
192,464,10,385,1,1,0,2,3,0,866,0,5,871,0
193,155,29,541,4,4,2,1,6,2,744,0,3,747,0
194,313,13,241,4,0,1,1,5,2,580,0,8,588,0
195,366,8,163,1,2,1,0,3,1,545,0,3,548,0
196,388,17,554,4,9,1,4,10,3,990,0,8,998,0
197,349,12,126,0,2,0,1,3,0,493,0,3,496,0
198,344,6,245,5,2,3,1,2,2,610,0,7,617,0
199,555,22,303,5,7,1,2,5,3,903,0,14,917,0
200,441,17,357,5,3,0,1,4,0,828,0,5,833,0
201,383,16,314,6,2,1,0,6,3,731,0,5,736,0
202,401,14,397,6,3,1,1,6,2,831,0,7,838,0
203,233,14,212,1,0,1,3,0,1,465,0,3,468,0
204,561,43,388,6,5,1,2,4,4,1014,0,12,1026,0
205,196,4,162,1,0,0,0,4,1,368,0,3,371,0
206,345,41,299,3,0,2,3,4,3,700,0,14,714,0
207,277,8,222,1,0,0,0,3,1,512,0,1,513,0
208,402,17,317,7,2,1,2,4,3,755,0,13,768,0
209,266,4,138,2,3,0,0,1,0,414,0,5,419,0
210,469,8,340,3,0,1,3,6,5,835,0,9,844,0
211,223,16,197,3,9,1,2,2,2,455,0,6,461,0
212,354,7,368,9,1,1,4,8,2,754,0,5,759,0
213,437,27,633,7,4,1,4,26,4,1143,0,17,1160,0
214,486,9,396,7,6,0,5,8,0,917,0,8,925,0
215,384,20,346,8,5,0,6,8,2,779,0,11,790,0
216,250,28,324,4,6,1,1,2,1,617,0,2,619,0
217,530,18,266,2,4,2,3,3,4,832,0,11,843,0
218,177,30,722,5,8,1,0,17,3,963,0,10,973,0
219,427,44,504,4,5,2,3,12,2,1003,0,9,1012,0
220,436,13,391,6,3,1,3,5,3,861,0,11,872,0
221,319,22,445,3,3,0,2,6,0,800,0,3,803,0
222,293,13,613,5,5,3,1,7,3,943,0,17,960,0
223,380,36,646,9,15,2,2,12,4,1106,0,12,1118,0
224,333,22,308,3,9,0,0,0,0,675,0,3,678,0
225,404,27,438,5,6,1,3,5,2,891,0,11,902,0
226,354,17,531,13,4,1,4,7,1,932,0,13,945,0
227,166,14,423,5,1,2,3,3,0,617,0,4,621,0
228,187,11,377,2,1,0,0,5,0,583,0,7,590,0
229,240,15,343,8,7,2,5,6,2,628,0,4,632,0
230,238,18,357,3,7,2,0,3,0,628,0,9,637,0
231,341,51,371,3,3,1,0,6,0,776,0,9,785,0
232,221,16,384,6,3,1,1,7,2,641,0,7,648,0
233,202,5,226,3,0,1,0,1,1,439,0,3,442,0
234,124,6,279,3,0,1,0,3,0,416,0,3,419,0
235,388,11,284,5,3,0,4,9,3,707,0,8,715,0
236,339,9,203,0,2,1,3,4,5,566,0,12,578,0
237,220,4,370,10,4,4,3,7,2,624,0,6,630,0
238,158,8,217,3,3,0,2,2,1,394,0,5,399,0
239,380,16,406,4,4,0,0,1,0,811,0,9,820,0
240,260,12,438,4,5,0,1,5,1,726,0,5,731,0
241,174,10,254,1,2,1,1,3,1,447,0,7,454,0
242,201,23,266,4,6,1,1,8,3,513,0,5,518,0
243,283,9,357,8,1,0,3,25,4,690,0,18,708,0
244,242,9,206,6,7,5,2,10,6,493,0,22,515,0
245,272,7,252,9,1,0,1,0,1,543,0,3,546,0
246,203,13,209,7,5,2,4,6,4,453,0,9,462,0
247,279,3,293,2,1,1,1,1,1,582,0,7,589,0
248,292,7,384,5,4,2,2,4,1,701,0,5,706,0
249,346,9,406,4,3,2,3,8,4,785,0,12,797,0
250,506,12,352,6,9,1,1,6,5,898,0,17,915,0
251,269,7,296,4,2,1,1,3,0,583,0,2,585,0
252,237,10,342,2,11,0,1,5,2,610,0,8,618,0
253,579,24,435,8,4,3,1,6,3,1063,0,6,1069,0
254,377,23,363,5,6,2,3,15,0,794,0,11,805,0
255,480,28,357,10,2,2,1,11,8,899,0,22,921,0
256,274,33,337,2,6,0,1,7,3,663,0,13,676,0
257,189,7,222,2,1,0,0,1,1,423,0,4,427,0
258,322,16,417,4,6,4,0,2,5,776,0,8,784,0
259,386,10,295,5,1,1,0,6,0,704,0,5,709,0
260,231,11,224,2,2,0,0,3,0,473,0,6,479,0
261,400,13,407,3,4,3,1,6,1,838,0,8,846,0
262,416,19,370,5,2,1,6,4,3,826,0,17,843,0
263,127,14,528,9,6,2,1,7,4,698,0,5,703,0
264,202,11,356,1,3,1,1,2,1,578,0,2,580,0
265,365,17,370,1,1,1,2,3,2,762,0,5,767,0
266,443,11,476,3,2,0,1,1,0,937,0,8,945,0
267,162,7,185,1,0,0,1,1,0,357,0,1,358,0
268,412,20,574,4,5,3,2,5,1,1026,0,5,1031,0
269,606,9,373,4,1,1,1,5,0,1000,0,3,1003,0
270,454,7,603,6,2,0,1,3,2,1078,0,10,1088,0
271,334,9,394,4,1,0,1,12,2,757,0,11,768,0
272,78,11,574,7,5,0,2,5,0,682,0,5,687,0
273,439,6,258,10,0,2,0,1,1,717,0,5,722,0
1,501,21,219,3,94,2,2,2,3,847,0,12,859,0
2,184,19,258,3,92,4,0,0,2,562,0,4,566,0
3,437,21,150,4,126,3,1,3,0,745,0,7,752,0
4,263,27,100,0,64,0,0,2,0,456,0,8,464,0
5,281,28,112,1,54,1,2,0,0,479,0,3,482,0
6,486,36,128,3,78,7,1,1,2,742,0,14,756,0
7,367,24,94,2,87,3,3,0,1,581,0,5,586,0
8,337,27,110,2,49,2,2,1,1,531,0,6,537,0
9,437,21,150,3,56,4,1,5,0,677,0,10,687,0
10,478,59,111,0,33,0,4,3,0,688,0,9,697,0
11,638,51,184,4,80,3,1,3,4,968,0,15,983,0
12,381,11,191,4,98,9,5,3,8,710,0,14,724,0
13,518,5,66,2,46,3,0,1,1,642,0,8,650,1
14,473,55,175,4,93,1,5,1,2,809,0,8,817,0
15,420,47,121,4,56,3,5,3,3,662,0,9,671,0
16,446,46,156,1,85,0,0,0,0,734,0,11,745,0
17,482,51,141,4,70,0,2,0,1,751,0,2,753,0
18,267,47,141,3,48,1,4,4,0,515,0,7,522,0
19,318,35,161,5,64,0,6,0,0,589,0,8,597,0
20,495,7,43,6,24,1,1,1,0,578,0,9,587,0
21,276,6,30,0,29,1,0,0,1,343,0,5,348,0
22,434,1,52,0,18,0,0,0,0,505,0,3,508,0
23,445,25,165,4,29,1,0,3,1,673,0,11,684,0
24,343,63,162,4,16,3,0,1,2,594,0,9,603,0
25,372,13,95,3,22,3,4,1,1,514,0,3,517,0
26,491,5,42,1,41,0,3,0,1,584,0,7,591,0
27,547,9,71,1,27,2,0,4,1,662,0,4,666,0
28,334,4,34,0,14,1,2,1,0,390,0,1,391,0
29,521,48,129,4,27,0,1,5,4,739,0,9,748,0
30,229,24,90,1,13,1,2,1,1,362,0,1,363,0
31,591,48,130,1,20,1,0,1,0,792,0,6,798,0
32,606,54,188,1,16,2,6,5,5,883,0,11,894,0
33,458,79,199,3,44,2,3,2,4,794,0,4,798,0
34,295,6,105,1,6,1,0,2,2,418,0,6,424,0
35,323,30,286,4,7,1,1,0,0,652,0,4,656,0
36,639,16,152,7,18,1,1,3,2,839,0,16,855,0
37,323,18,161,0,29,2,1,1,2,537,0,9,546,0
38,508,15,192,1,20,2,2,1,0,741,0,4,745,0
39,320,9,174,1,10,0,0,0,1,515,0,0,515,0
40,401,10,192,1,16,0,0,1,1,622,0,3,625,0
41,120,3,42,0,8,0,0,0,0,173,0,2,175,0
42,601,24,46,0,21,1,1,0,1,695,0,7,702,0
43,292,7,35,1,10,1,2,1,0,349,0,2,351,0
44,355,14,58,1,15,0,1,0,2,446,0,4,450,0
45,402,29,126,0,15,1,1,0,1,575,0,4,579,0
46,293,29,113,1,18,1,4,4,2,465,0,7,472,0
47,418,35,147,3,17,1,1,0,2,624,0,7,631,0
48,346,44,140,1,10,0,1,2,1,545,0,11,556,0
49,580,49,255,4,39,5,3,4,1,940,0,10,950,0
50,357,14,164,3,5,0,0,8,3,554,0,12,566,0
51,612,57,252,8,23,6,3,21,6,988,0,32,1020,0
52,336,35,182,0,22,0,1,4,1,581,0,8,589,0
53,441,57,257,1,40,2,1,2,5,806,0,7,813,0
54,527,74,273,5,61,1,1,4,2,948,0,27,975,0
55,224,61,95,2,18,3,0,2,0,405,0,9,414,0
56,249,44,113,1,17,2,3,4,2,435,0,4,439,0
57,325,51,104,2,26,1,4,2,3,518,0,6,524,0
58,274,60,205,4,16,0,0,1,0,560,0,7,567,0
59,279,47,195,1,10,0,2,1,0,535,0,4,539,0
60,280,56,133,0,19,1,1,0,0,490,0,3,493,0
61,352,61,282,2,23,1,0,1,0,722,0,13,735,0
62,134,27,92,0,10,0,1,0,0,264,0,2,266,0
63,410,35,140,4,6,0,3,1,0,599,0,7,606,0
64,504,31,211,1,18,2,1,0,1,769,0,7,776,0
65,356,33,177,1,13,1,2,0,3,586,0,9,595,0
66,347,35,150,1,12,1,0,0,0,546,0,2,548,0
67,405,23,175,2,31,2,2,1,1,642,0,10,652,0
68,278,31,185,1,40,1,0,2,1,539,0,2,541,0
69,65,17,467,3,19,1,1,1,2,576,0,7,583,0
70,25,5,475,1,6,1,0,4,0,517,0,5,522,0
71,25,7,617,7,27,0,0,15,0,698,0,5,703,0
72,189,8,625,6,9,1,3,2,2,845,0,3,848,0
73,177,5,241,1,3,2,2,2,1,434,0,6,440,0
74,548,15,89,0,11,0,1,2,1,667,0,16,683,0
75,411,24,114,3,17,1,0,1,3,574,0,5,579,0
76,348,9,151,1,12,0,1,0,0,522,0,11,533,0
77,370,15,114,1,13,2,1,2,3,521,0,5,526,0
78,110,8,686,4,15,1,0,12,0,836,0,8,844,0
79,20,33,820,12,17,0,7,12,2,923,0,2,925,0
80,17,31,706,3,14,2,2,8,2,785,0,9,794,0
81,23,14,445,5,7,1,3,4,1,503,0,4,507,0
82,23,15,655,7,21,1,9,10,3,744,0,4,748,0
83,17,25,628,7,27,0,4,11,7,726,0,9,735,0
84,21,21,581,7,21,3,3,15,3,675,0,5,680,0
85,24,16,840,8,29,2,1,9,3,932,0,8,940,0
86,22,7,637,4,11,3,0,7,4,695,0,5,700,2
87,25,69,441,3,22,1,3,3,5,572,0,5,577,0
88,17,20,444,5,13,2,2,1,0,504,0,6,510,0
89,26,24,599,17,18,4,3,15,1,707,0,8,715,0
90,11,13,393,7,12,1,1,8,0,446,0,7,453,0
91,40,33,574,7,19,0,1,7,6,687,0,9,696,0
92,217,29,355,3,14,2,3,2,1,626,0,12,638,0
93,269,20,141,3,5,0,0,2,0,440,0,5,445,0
94,34,12,325,5,10,3,2,7,4,402,0,6,408,0
95,55,19,576,9,14,4,4,12,3,696,0,11,707,0
96,152,9,434,7,16,1,3,12,1,635,0,9,644,0
97,169,21,502,8,33,3,4,9,3,752,0,6,758,0
98,444,8,285,5,14,3,6,9,0,774,0,11,785,0
99,258,30,136,0,9,0,2,0,1,436,0,6,442,0
100,425,46,161,2,20,4,1,0,0,659,0,12,671,0
101,358,53,147,2,11,2,4,0,0,577,0,7,584,0
102,135,42,372,5,6,0,0,11,4,575,0,13,588,0
103,256,40,82,1,11,4,0,1,1,396,0,9,405,0
104,490,132,155,5,26,1,0,2,2,813,0,7,820,0
105,429,51,174,1,16,0,3,0,2,676,0,12,688,0
106,528,48,180,1,21,0,1,2,1,782,0,12,794,0
107,533,96,238,1,31,3,4,1,0,907,0,20,927,0
108,237,43,80,0,7,0,0,0,1,368,0,4,372,0
109,326,63,173,0,15,1,0,1,0,579,0,6,585,0
110,419,84,210,0,32,1,1,0,1,748,0,14,762,0
111,454,231,174,2,17,6,8,9,11,912,0,15,927,0
112,270,49,124,2,34,1,1,0,1,482,0,8,490,0
113,438,28,176,3,96,1,1,3,0,746,0,4,750,0
114,380,68,168,2,126,1,1,1,0,747,0,9,756,0
115,437,40,163,4,65,2,0,0,2,713,0,7,720,0
116,453,32,77,3,50,1,0,0,2,618,0,17,635,0
117,239,26,118,1,30,0,0,2,0,416,0,4,420,0
118,395,18,64,1,44,1,0,0,0,523,0,8,531,0
119,275,40,119,2,26,1,0,0,0,463,0,8,471,0
120,283,38,458,1,36,3,3,15,3,840,0,9,849,0
121,384,24,233,3,18,1,2,2,1,668,0,7,675,0
122,784,68,165,5,11,6,7,4,4,1054,0,11,1065,0
123,596,69,155,1,20,3,0,3,3,850,0,6,856,0
124,534,74,202,6,14,1,12,4,1,848,0,10,858,0
125,417,91,135,2,13,2,2,2,4,668,0,9,677,0
126,412,164,142,9,19,4,8,5,6,769,0,5,774,0
127,376,16,412,3,16,0,2,4,0,829,0,8,837,0
128,422,35,319,3,22,0,1,6,0,808,0,4,812,0
129,318,37,145,1,13,2,2,0,0,518,0,10,528,0
130,514,29,185,1,14,1,3,2,1,750,0,12,762,0
131,328,30,167,1,19,2,0,0,1,548,0,3,551,0
132,394,16,174,2,32,1,1,1,0,621,0,9,630,0
133,348,30,196,3,39,2,2,3,4,627,0,14,641,0
134,436,44,176,4,23,4,0,3,1,691,0,3,694,0
135,320,36,147,0,8,2,2,2,0,517,0,2,519,1
136,684,39,213,3,24,2,3,4,3,975,0,19,994,0
137,220,4,74,1,18,0,1,2,1,321,0,6,327,0
138,565,37,172,5,45,1,0,0,0,825,0,6,831,0
139,386,48,176,2,23,2,1,2,3,643,0,8,651,0
140,459,15,148,4,28,1,1,1,2,659,0,12,671,0
141,382,33,157,1,68,0,0,1,1,643,0,11,654,0
142,599,25,181,5,86,2,1,4,1,904,0,13,917,0
143,583,53,208,4,39,1,1,1,3,893,0,9,902,0
144,340,18,132,2,32,1,1,1,0,527,0,6,533,0
145,342,17,103,1,46,0,0,5,0,514,0,4,518,0
146,359,13,98,3,32,1,1,2,1,510,0,5,515,0
147,285,34,231,4,20,2,1,11,4,592,0,12,604,0
148,445,21,364,7,11,4,4,19,8,883,0,14,897,0
149,671,22,134,0,63,0,0,5,5,900,0,9,909,0
150,333,26,259,4,69,4,0,4,5,704,0,2,706,0
151,389,11,121,1,40,4,0,3,0,569,0,1,570,0
152,286,18,272,7,45,3,5,8,2,646,0,13,659,0
153,540,12,114,5,28,1,1,2,2,705,0,12,717,1
154,193,38,126,3,21,2,2,2,0,387,0,5,392,0
155,188,33,87,1,18,0,0,0,0,327,0,12,339,0
156,227,23,111,3,22,0,2,0,1,389,0,15,404,0
157,181,34,136,0,11,2,0,0,2,366,0,4,370,0
158,330,54,281,2,15,1,4,3,0,690,0,10,700,0
159,200,43,189,1,15,0,1,0,0,449,0,5,454,0
160,247,42,170,2,14,1,2,0,0,478,0,9,487,0
161,193,44,216,1,25,0,1,1,0,481,0,2,483,0
162,279,79,294,2,35,1,0,2,2,694,0,17,711,0
163,202,67,202,0,27,0,0,2,0,500,0,11,511,0
164,166,25,160,0,13,0,0,0,1,365,0,9,374,0
165,434,57,290,1,27,1,2,8,2,822,0,10,832,0
166,386,98,310,1,4,0,6,2,2,809,0,4,813,0
167,534,67,305,5,19,2,2,2,2,938,0,5,943,0
168,332,66,347,5,12,1,3,2,1,769,0,2,771,0
169,412,57,231,0,6,1,5,2,1,715,0,2,717,0
170,203,66,202,3,7,0,6,1,2,490,0,7,497,0
171,301,46,196,2,17,2,9,2,0,575,0,4,579,0
172,363,51,262,2,3,0,8,3,1,693,0,3,696,0
173,501,76,345,1,12,2,7,5,1,950,0,8,958,0
174,581,136,260,10,20,6,6,12,14,1045,0,35,1080,0
175,420,34,291,5,10,1,6,8,1,776,0,5,781,0
176,562,143,223,2,17,1,5,15,8,976,0,14,990,0
177,456,9,104,1,13,0,1,3,1,588,0,11,599,0
178,435,16,120,3,22,2,2,3,2,605,0,3,608,0
179,442,15,103,1,20,3,0,4,0,588,0,7,595,0
180,347,6,59,0,8,2,3,8,0,433,0,6,439,0
181,632,12,151,3,32,5,1,5,3,844,0,23,867,0
182,724,15,105,0,16,2,0,1,2,865,0,17,882,0
183,601,8,101,7,25,5,3,5,4,759,0,24,783,0
184,703,4,98,2,26,4,4,1,3,845,0,14,859,0
185,467,27,267,4,32,4,1,1,1,804,0,8,812,0
186,321,19,146,3,22,2,0,3,0,516,0,11,527,0
187,345,20,171,0,27,0,2,2,2,569,0,5,574,0
188,301,54,122,2,28,2,1,1,2,513,0,5,518,0
189,438,70,115,2,14,1,2,5,15,662,0,4,666,0
190,336,29,62,3,26,1,2,0,2,461,0,8,469,0
191,322,29,58,1,25,0,1,0,3,439,0,6,445,0
192,556,49,91,2,16,2,4,2,2,724,0,2,726,0
193,435,36,85,0,16,0,0,1,0,573,0,3,576,0
194,389,46,27,3,21,2,1,1,1,491,0,9,500,0
195,360,81,88,3,7,1,3,7,11,561,0,19,580,0
196,206,10,60,3,6,0,0,0,0,285,0,5,290,0
197,516,9,145,2,14,2,1,8,4,701,0,11,712,0
198,256,14,107,3,10,3,2,3,3,401,0,12,413,0
199,226,12,65,0,5,0,0,0,1,309,0,3,312,0
200,216,5,68,0,21,1,0,0,0,311,0,2,313,0
201,262,5,56,1,19,0,0,2,1,346,0,3,349,0
202,186,0,51,0,23,1,1,0,0,262,0,6,268,0
203,361,21,97,4,36,0,2,0,1,522,0,5,527,0
204,129,4,17,0,17,2,0,0,1,170,0,3,173,0
205,265,7,74,0,23,0,2,4,0,375,0,8,383,0
206,172,8,62,2,33,0,2,1,0,280,0,3,283,0
207,462,15,165,0,32,2,0,2,0,678,0,3,681,0
208,158,7,58,0,20,1,1,1,0,246,0,3,249,0
209,381,15,53,0,43,4,0,2,5,503,0,6,509,0
210,353,3,34,1,20,2,0,1,3,417,0,4,421,0
211,316,3,78,0,12,0,1,1,0,411,0,6,417,0
212,261,4,53,2,16,0,1,1,1,339,0,7,346,0
213,381,15,90,0,37,3,1,1,2,530,0,8,538,0
214,265,11,67,2,28,0,2,3,0,378,0,3,381,0
215,319,7,64,1,24,1,2,1,0,419,0,3,422,0
216,158,3,28,0,16,1,0,0,0,206,0,2,208,0
217,262,8,48,0,30,0,1,0,0,349,0,2,351,0
218,396,9,114,3,36,2,4,5,7,576,0,12,588,1
219,361,9,82,1,23,0,2,3,0,481,0,4,485,0
220,286,7,52,2,32,1,0,1,1,382,0,5,387,0
221,246,4,69,3,27,0,0,0,0,349,0,4,353,0
222,299,3,43,1,16,0,1,2,1,366,0,5,371,0
223,271,7,129,3,45,1,2,2,0,460,0,10,470,0
224,366,8,100,4,6,2,2,6,4,498,0,5,503,0
225,389,11,117,3,55,1,1,2,1,580,0,6,586,0
226,303,7,41,2,13,0,1,0,0,367,0,6,373,0
227,294,7,26,1,14,0,1,3,2,348,0,4,352,0
228,563,6,87,2,20,0,5,1,3,687,0,17,704,0
229,439,16,194,2,13,0,0,5,2,671,0,2,673,0
230,121,5,100,0,20,0,0,1,0,247,0,5,252,0
231,236,4,96,2,13,1,0,2,1,355,0,2,357,0
232,336,10,109,2,19,1,1,0,0,478,0,5,483,0
233,351,7,227,3,25,2,1,1,0,617,0,6,623,0
234,285,11,163,2,38,0,1,1,0,501,0,2,503,0
235,293,6,147,2,27,2,1,2,1,481,0,3,484,0
236,99,1,91,1,9,1,0,2,1,205,0,4,209,0
237,261,5,96,1,24,0,0,0,0,387,0,7,394,0
238,321,17,89,0,12,1,1,1,0,442,0,5,447,0
239,273,7,86,1,26,2,0,0,1,396,0,11,407,0
240,524,4,120,1,49,0,3,1,7,709,0,12,721,0
241,365,11,79,1,30,3,1,2,1,493,0,9,502,0
242,508,20,101,5,26,4,3,6,6,679,0,12,691,0
243,437,17,314,11,12,8,8,21,10,838,0,27,865,0
244,307,3,56,2,3,1,1,1,4,378,0,10,388,1
245,312,8,202,7,55,3,3,13,2,605,0,21,626,0
246,120,13,392,3,168,4,3,31,4,738,0,11,749,0
247,125,4,92,2,74,5,2,8,4,316,0,11,327,0
248,275,4,68,3,36,1,2,5,2,396,0,5,401,0
249,155,4,123,4,36,1,0,11,1,335,0,9,344,0
250,312,5,55,3,43,1,0,0,0,419,0,11,430,0
251,636,18,52,5,70,1,0,3,3,788,0,22,810,0
252,474,21,111,2,97,2,1,2,0,710,0,12,722,0
253,258,17,37,4,76,2,3,1,1,399,0,2,401,0
254,362,19,153,1,64,7,1,3,2,612,0,8,620,0
255,570,12,141,3,29,2,2,4,2,765,0,15,780,0
256,344,8,104,1,33,2,2,1,1,496,0,6,502,0
257,367,16,90,2,15,6,2,4,1,503,0,10,513,0
258,198,10,53,0,20,1,0,0,0,282,0,6,288,0
259,405,117,260,5,18,2,2,4,6,819,0,10,829,0
260,401,38,97,1,37,2,1,0,2,579,0,8,587,0
261,359,18,95,1,50,2,5,3,2,535,0,6,541,0
262,331,11,51,1,62,1,0,0,0,457,0,6,463,0
263,219,13,42,2,64,2,0,1,0,343,0,6,349,0
264,173,12,57,0,65,1,0,2,0,310,0,8,318,0
265,408,14,129,2,131,2,3,2,4,695,0,14,709,0
266,430,5,95,2,209,3,1,3,1,749,0,9,758,0
267,477,13,112,2,160,5,1,3,5,778,0,19,797,0
268,559,133,118,3,40,1,4,5,4,867,0,20,887,0
269,418,29,56,6,75,1,3,1,1,590,0,10,600,0
270,526,16,107,2,85,5,2,2,6,751,0,9,760,0
1,487,15,623,15,5,2,3,14,7,1171,0,15,1186,0
2,147,11,822,11,2,3,2,10,2,1010,0,4,1014,0
3,92,13,365,4,0,0,0,12,3,489,0,5,494,0
4,329,13,450,11,3,2,1,7,6,822,0,14,836,0
5,210,23,548,11,6,3,6,22,5,834,0,9,843,0
6,362,36,672,13,17,4,6,14,4,1128,0,8,1136,0
7,303,29,465,6,15,2,1,7,5,833,0,11,844,0
8,195,16,261,5,3,5,3,5,3,496,0,9,505,0
9,301,31,565,7,6,4,4,11,2,931,0,3,934,0
10,637,24,532,9,5,2,4,9,5,1227,0,18,1245,0
11,297,29,458,13,12,2,4,11,4,830,0,10,840,0
12,222,26,338,4,7,0,2,7,0,606,0,9,615,0
13,241,14,677,7,4,1,2,5,2,953,0,4,957,0
14,141,23,264,3,6,0,0,3,1,441,0,7,448,0
15,438,32,532,12,10,4,3,14,1,1046,0,11,1057,0
16,240,27,281,3,1,2,0,6,0,560,0,5,565,0
17,431,32,435,10,10,1,3,12,1,935,0,13,948,0
18,469,25,309,15,8,3,4,8,7,848,0,10,858,0
19,134,63,435,4,10,3,2,4,9,664,0,12,676,0
20,234,116,273,4,5,1,2,1,5,641,0,4,645,0
21,564,71,387,4,11,4,7,6,1,1055,0,16,1071,0
22,224,28,371,3,4,0,3,6,5,644,0,12,656,0
23,219,54,241,1,3,0,0,2,0,520,0,4,524,0
24,325,38,471,12,13,3,2,7,5,876,0,7,883,0
25,261,48,248,2,6,0,1,4,4,574,0,3,577,0
26,405,89,273,7,4,2,2,6,9,797,0,12,809,0
27,412,50,341,5,1,2,2,2,4,819,0,12,831,0
28,488,41,350,7,3,0,0,2,5,896,0,2,898,0
29,342,19,497,6,4,4,4,4,1,881,0,8,889,0
30,400,14,505,4,3,0,2,6,1,935,0,3,938,0
31,294,66,278,4,7,3,4,7,1,664,0,10,674,0
32,244,29,167,3,4,0,1,2,2,452,0,0,452,0
33,670,67,391,7,8,0,2,4,7,1156,0,13,1169,0
34,455,26,196,3,7,1,4,0,4,696,0,4,700,0
35,271,8,230,1,0,0,0,1,0,511,0,3,514,0
36,540,57,571,11,15,8,5,8,3,1218,0,9,1227,0
37,257,88,220,4,1,2,2,1,0,575,0,4,579,0
38,398,27,493,14,16,3,4,10,6,971,0,11,982,0
39,585,20,508,3,7,4,2,2,0,1131,0,11,1142,0
40,440,69,488,6,117,8,12,5,3,1148,0,8,1156,0
41,612,7,392,6,4,1,6,5,4,1037,0,9,1046,0
42,565,23,494,13,17,7,8,3,11,1141,0,7,1148,0
43,383,31,430,7,11,1,0,3,4,870,0,5,875,0
44,438,32,352,2,11,2,2,4,6,849,0,7,856,0
45,300,35,382,4,4,0,4,4,3,736,0,14,750,0
46,510,48,491,8,4,3,2,11,2,1079,0,12,1091,0
47,87,8,224,1,3,0,40,2,1,366,0,0,366,0
48,117,20,289,5,3,1,122,3,1,561,0,3,564,0
49,429,81,372,5,13,10,6,8,2,926,0,4,930,0
50,226,52,318,3,4,4,5,2,2,616,0,6,622,0
51,279,29,136,1,2,1,6,1,1,456,0,5,461,0
52,314,123,383,5,16,0,1,8,3,853,0,4,857,0
53,424,126,398,7,7,3,8,5,4,982,0,5,987,0
54,405,86,398,14,6,10,10,10,5,944,0,11,955,0
55,351,130,262,8,10,2,10,4,4,781,0,9,790,0
56,165,24,208,4,2,1,5,4,4,417,0,7,424,0
57,298,37,303,4,6,2,36,9,1,696,0,4,700,0
58,158,9,90,4,0,0,115,0,1,377,0,3,380,0
59,159,6,175,0,1,1,5,5,1,353,0,4,357,0
60,269,17,366,8,9,4,3,5,2,683,0,4,687,0
61,334,30,303,3,5,2,4,7,4,692,0,9,701,0
62,552,45,556,7,3,4,3,13,6,1189,0,10,1199,0
63,529,60,573,10,4,3,3,10,1,1193,0,9,1202,0
64,271,15,492,4,5,2,3,17,3,812,0,4,816,0
65,297,15,342,2,3,2,3,5,1,670,0,3,673,0
66,352,4,224,2,2,0,1,6,0,591,0,6,597,0
67,687,31,477,12,9,3,6,8,4,1237,0,10,1247,0
68,318,12,385,9,13,5,3,10,0,755,0,12,767,0
69,86,12,413,2,53,5,3,6,1,581,0,3,584,0
70,530,14,456,3,2,4,1,5,2,1017,0,10,1027,0
71,554,21,532,7,4,0,0,5,1,1124,0,13,1137,0
72,590,39,473,2,5,5,27,6,3,1150,0,10,1160,0
73,403,35,477,16,8,5,8,17,8,977,0,13,990,0
74,373,18,488,3,5,0,22,3,1,913,0,0,913,0
75,470,14,398,4,2,0,3,4,1,896,0,5,901,0
76,310,14,346,12,5,1,3,6,1,698,0,7,705,0
77,374,15,253,5,9,1,2,2,2,663,0,7,670,0
78,422,26,387,8,7,3,1,2,2,858,0,5,863,0
79,509,33,320,4,17,2,10,8,0,903,0,6,909,0
80,294,25,263,8,9,2,1,6,1,609,0,14,623,0
81,350,33,246,3,8,2,1,1,0,644,0,4,648,0
82,354,27,339,8,7,1,3,13,2,754,0,8,762,0
83,679,15,315,9,9,3,7,8,4,1049,0,19,1068,0
84,371,18,426,6,4,1,1,2,1,830,0,4,834,0
85,301,11,342,5,3,3,1,12,3,681,0,4,685,0
86,240,76,644,7,35,1,3,6,5,1017,0,13,1030,0
87,160,61,370,3,18,0,4,3,3,622,0,2,624,0
88,244,144,342,11,21,1,2,7,0,772,0,5,777,0
89,545,18,361,6,9,2,7,10,2,960,0,19,979,0
90,411,17,283,5,11,2,4,2,3,738,0,10,748,0
91,333,10,284,5,7,0,3,6,0,648,0,8,656,0
92,369,9,624,5,9,1,2,8,4,1031,0,11,1042,0
93,447,20,344,5,18,5,3,4,5,851,0,13,864,0
94,483,62,436,2,4,4,3,12,3,1009,0,18,1027,0
95,436,13,242,1,8,0,1,4,1,706,0,9,715,0
96,161,8,263,5,3,0,0,1,1,442,0,0,442,0
97,392,56,423,9,7,5,7,4,5,908,0,6,914,0
98,467,89,305,5,6,3,5,7,3,890,0,10,900,0
99,383,22,354,2,8,1,3,3,0,776,0,6,782,0
100,611,47,464,11,8,2,9,8,4,1164,0,14,1178,0
101,417,14,337,5,8,1,4,13,0,799,0,8,807,0
102,393,33,424,8,12,6,2,14,4,896,0,12,908,0
103,156,87,437,7,5,0,2,1,3,698,0,5,703,0
104,279,40,304,6,0,1,0,5,1,636,0,8,644,0
105,362,24,196,2,15,3,3,5,2,612,0,5,617,0
106,327,32,341,6,8,0,5,5,6,730,0,6,736,0
107,683,31,277,7,9,4,0,2,7,1020,0,10,1030,0
108,562,49,130,2,6,0,3,3,2,757,0,9,766,0
109,493,63,444,10,7,3,3,5,2,1030,0,13,1043,0
110,334,66,216,3,1,0,2,2,6,630,0,2,632,0
111,360,55,245,9,6,2,1,8,4,690,0,10,700,0
112,315,33,212,0,4,2,0,3,0,569,0,2,571,0
113,351,18,193,1,2,0,1,2,0,568,0,6,574,0
114,480,40,221,4,7,2,6,4,2,766,0,14,780,0
115,402,85,243,2,10,5,3,1,1,752,0,5,757,0
116,402,38,242,6,6,4,1,7,3,709,0,11,720,0
117,336,46,332,1,6,1,2,7,2,733,0,6,739,0
118,451,9,185,4,4,2,1,1,2,659,0,2,661,0
119,431,52,172,3,1,0,3,1,3,666,0,7,673,0
120,499,29,224,8,3,5,1,1,0,770,0,12,782,0
121,646,68,331,10,8,3,5,8,10,1089,0,10,1099,0
122,584,62,445,5,9,3,3,7,0,1118,0,6,1124,0
123,477,22,340,4,10,2,1,5,2,863,0,17,880,0
124,430,35,307,2,7,1,5,8,1,796,0,7,803,0
125,506,96,388,5,10,5,4,5,1,1020,0,9,1029,0
126,329,32,462,6,7,4,10,10,3,863,0,16,879,0
127,428,33,162,0,2,1,9,3,3,641,0,5,646,0
128,483,22,211,5,11,0,6,1,1,740,0,8,748,0
129,446,43,315,1,15,1,1,2,4,828,0,8,836,0
130,471,69,214,4,14,4,2,3,3,784,0,9,793,0
131,300,37,180,3,5,1,2,0,1,529,0,5,534,0
132,292,36,207,2,10,1,0,3,1,552,0,6,558,0
133,273,52,217,2,10,1,6,1,1,563,0,10,573,0
134,382,40,178,1,12,4,3,1,1,622,0,12,634,0
135,441,29,336,2,5,1,6,4,1,825,0,6,831,0
136,362,25,214,1,11,0,3,2,1,619,0,6,625,0
137,520,25,210,2,17,3,1,4,2,784,0,6,790,0
138,475,128,209,2,13,1,0,2,9,839,0,9,848,0
139,362,88,318,1,14,5,1,8,6,803,0,8,811,0
140,233,22,418,10,4,1,5,9,5,707,0,8,715,0
141,218,110,538,4,5,2,2,5,3,887,0,9,896,0
142,166,35,342,6,5,0,1,10,1,566,0,5,571,0
143,568,86,395,2,3,4,5,6,5,1074,0,25,1099,0
144,246,68,415,8,10,3,3,4,5,762,0,12,774,0
145,467,44,186,0,16,0,1,5,5,724,0,8,732,0
146,285,31,280,2,0,3,0,1,0,602,0,8,610,0
147,409,152,523,3,9,4,0,4,1,1105,0,8,1113,0
148,417,207,502,6,11,7,4,4,2,1160,0,9,1169,0
149,561,14,379,2,1,1,3,10,1,972,0,4,976,0
150,460,83,346,2,6,0,1,3,5,906,0,6,912,0
151,364,16,338,3,7,1,0,4,1,734,0,7,741,0
152,123,81,473,6,3,4,1,2,1,694,0,6,700,0
153,196,69,441,3,7,3,3,4,0,726,0,4,730,0
154,412,37,183,10,4,2,3,3,4,658,0,9,667,0
155,259,12,100,1,3,1,1,1,0,378,0,5,383,0
156,320,23,258,2,6,1,3,2,2,617,0,8,625,0
157,267,42,269,2,2,0,4,6,2,594,0,4,598,0
158,418,51,226,5,3,2,3,3,1,712,0,7,719,0
159,301,28,280,4,6,1,5,6,3,634,0,8,642,0
160,405,32,197,2,0,1,1,1,0,639,0,10,649,0
161,20,20,771,10,5,2,1,9,1,839,0,4,843,0
162,9,14,713,4,2,0,0,5,0,747,0,0,747,0
163,202,18,66,2,1,1,1,2,4,297,0,8,305,0
164,265,98,184,1,4,1,2,3,2,560,0,8,568,0
165,317,45,192,3,2,0,3,1,1,564,0,6,570,0
166,674,56,308,4,5,1,0,2,3,1053,0,20,1073,0
167,389,82,414,6,8,0,1,6,2,908,0,7,915,0
168,462,68,281,9,7,8,4,4,2,845,0,12,857,0
169,264,18,247,1,4,1,2,5,0,542,0,6,548,0
170,644,58,244,0,8,1,1,3,0,959,0,9,968,0
171,516,21,212,5,3,0,1,4,1,763,0,4,767,0
172,269,30,184,1,1,0,2,2,0,489,0,2,491,0
173,430,34,343,2,2,0,0,6,2,819,0,3,822,0
174,203,8,342,2,0,0,3,10,0,568,0,5,573,0
175,258,49,110,2,7,0,0,2,2,430,0,4,434,0
176,326,36,98,1,2,1,1,0,1,466,0,2,468,0
177,530,59,206,1,7,5,0,3,1,812,0,6,818,0
178,375,16,205,3,7,1,1,4,0,612,0,2,614,0
179,480,19,200,2,7,0,1,4,2,715,0,4,719,0
180,646,42,181,3,19,1,1,0,2,895,0,13,908,0
181,438,17,213,3,5,0,0,4,3,683,0,5,688,0
182,292,13,196,2,6,0,1,3,0,513,0,8,521,0
183,475,31,126,2,8,2,0,0,2,646,0,4,650,0
184,410,44,130,2,5,1,0,1,1,594,0,1,595,0
185,504,16,298,1,7,0,4,4,0,834,0,4,838,0
186,456,30,166,4,1,0,0,1,1,659,0,13,672,0
187,323,38,294,1,4,1,1,4,1,667,0,2,669,0
188,455,42,209,4,6,1,1,1,3,722,0,4,726,0
189,751,38,253,5,6,3,3,0,3,1062,0,18,1080,0
190,432,26,492,7,5,1,1,5,1,970,0,4,974,0
191,618,25,245,4,7,2,2,4,5,912,0,2,914,0
192,341,19,296,16,7,1,3,3,2,688,0,3,691,0
193,400,15,256,7,3,1,0,11,4,697,0,7,704,0
194,507,52,345,6,3,4,2,6,3,928,0,7,935,0
195,435,33,388,5,5,3,0,3,3,875,0,3,878,0
196,473,39,491,6,4,6,2,5,4,1030,0,10,1040,0
197,305,7,301,2,9,1,4,2,0,631,0,5,636,0
198,262,178,408,3,11,1,8,1,1,873,0,1,874,0
199,558,20,504,8,5,1,52,5,3,1156,0,4,1160,0
200,351,10,289,3,0,0,3,4,1,661,0,3,664,0
201,349,8,288,4,1,0,4,11,2,667,0,8,675,0
202,153,30,195,3,5,1,69,2,0,458,0,5,463,0
203,281,9,447,3,21,1,10,1,0,773,0,3,776,0
204,392,14,414,6,10,2,7,7,2,854,0,4,858,0
205,341,15,632,10,4,0,5,4,2,1013,0,9,1022,0
206,289,29,365,3,10,2,3,9,2,712,0,3,715,0
207,266,9,221,1,2,2,2,3,2,508,0,0,508,0
208,222,99,215,1,6,3,2,3,1,552,0,1,553,0
209,159,12,199,2,0,0,0,1,0,373,0,3,376,0
210,225,13,302,3,1,1,2,2,0,549,0,5,554,0
211,121,54,126,1,4,2,0,3,0,311,0,2,313,0
212,27,230,470,1,41,2,1,2,3,777,0,1,778,0
213,225,22,162,2,3,2,5,3,2,426,0,4,430,0
214,293,33,238,1,4,2,7,2,2,582,0,5,587,0
215,337,68,269,1,10,2,71,2,4,764,0,2,766,0
216,238,44,370,3,7,1,6,3,1,673,0,4,677,1
217,270,29,306,3,5,5,1,2,0,621,0,5,626,0
218,375,88,457,11,8,3,7,7,4,960,0,7,967,0
219,136,19,393,1,8,1,3,4,1,566,0,3,569,0
220,376,71,287,5,10,3,11,2,1,766,0,8,774,0
221,195,29,204,3,5,0,22,0,2,460,0,2,462,0
222,218,108,199,1,2,2,78,0,0,608,0,3,611,0
223,458,67,288,2,1,1,168,6,2,993,0,15,1008,0
224,292,104,325,3,9,2,132,4,4,875,0,5,880,0
225,319,157,394,10,9,1,87,3,4,984,0,7,991,0
226,391,94,336,3,9,3,38,4,6,884,0,4,888,0
227,145,13,160,1,5,1,7,0,0,332,0,4,336,0
228,360,238,540,3,6,9,23,5,8,1192,0,9,1201,0
229,241,5,288,5,3,3,3,3,2,553,0,6,559,0
230,406,30,194,2,5,1,0,1,2,641,0,2,643,0
231,285,14,269,3,2,0,1,0,2,576,0,1,577,0
232,327,6,252,3,9,0,2,2,1,602,0,7,609,0
233,360,23,254,4,1,0,4,2,2,650,0,4,654,0
234,408,35,390,3,6,2,4,3,3,854,0,5,859,0
235,317,13,276,5,8,0,14,1,2,636,0,2,638,0
236,221,39,175,1,2,1,300,2,1,742,0,9,751,0
237,281,19,295,2,0,2,44,4,2,649,0,6,655,0
238,590,39,431,5,8,3,19,6,2,1103,0,3,1106,0
239,481,14,303,5,3,1,10,3,4,824,0,6,830,0
240,180,6,185,1,1,1,3,0,0,377,0,2,379,0
241,533,17,483,3,5,2,8,4,0,1055,0,12,1067,0
242,311,6,136,2,1,0,16,2,0,474,0,4,478,0
243,312,8,331,3,2,0,10,2,1,669,0,2,671,0
244,421,11,360,3,4,2,3,0,4,808,0,3,811,0
245,427,37,471,5,8,2,24,8,2,984,0,6,990,0
246,247,115,400,4,0,0,26,2,1,795,0,2,797,0
247,344,12,270,3,0,0,2,2,0,633,0,3,636,0
248,306,26,237,1,5,0,6,6,1,588,0,5,593,0
249,375,27,287,1,6,0,4,2,3,705,0,4,709,0
250,235,133,488,4,11,3,3,8,5,890,0,7,897,0
251,213,39,331,0,14,0,6,2,0,605,0,11,616,0
252,438,53,437,11,13,5,5,6,4,972,0,8,980,0
253,300,53,240,2,3,0,3,3,0,604,0,3,607,0
254,300,133,153,4,4,2,1,6,7,610,0,2,612,0
255,372,89,475,3,6,2,13,10,7,977,0,6,983,0
256,214,17,162,1,1,0,0,2,3,400,0,1,401,0
257,259,89,214,4,6,2,2,2,0,578,0,4,582,0
258,355,52,317,3,3,4,2,2,1,739,0,3,742,0
259,361,35,385,4,13,0,2,4,2,806,0,9,815,0
260,300,19,139,3,2,0,1,1,4,469,0,3,472,0
261,349,150,471,3,2,5,32,6,3,1021,0,4,1025,0
262,178,26,163,1,1,1,1,0,3,374,0,2,376,0
263,391,67,207,3,6,1,10,2,3,690,0,7,697,0
264,541,74,509,10,8,5,9,3,4,1163,0,9,1172,0
265,240,37,137,1,4,2,7,4,1,433,0,2,435,0
266,475,47,320,3,12,1,5,1,1,865,0,3,868,0
267,737,41,254,0,15,2,3,5,1,1058,0,9,1067,0
268,283,12,191,0,6,1,3,4,0,500,0,5,505,0
269,372,16,224,7,5,1,1,9,2,637,0,8,645,0
1,581,71,450,10,13,1,5,2,2,1135,0,13,1148,0
2,560,56,325,6,13,7,3,7,3,980,0,26,1006,0
3,226,35,386,4,4,0,1,5,0,661,0,5,666,0
4,381,69,436,5,10,2,6,8,2,919,0,15,934,0
6,321,20,397,9,9,3,1,4,1,765,0,10,775,0
7,429,51,345,8,16,3,3,8,4,867,0,9,876,0
8,349,44,425,12,12,8,3,8,11,872,0,16,888,0
9,416,41,293,6,4,2,3,1,2,768,0,9,777,0
10,251,35,329,10,8,2,4,10,0,649,0,9,658,0
11,627,60,392,5,13,2,5,13,2,1119,0,15,1134,0
12,741,79,312,3,8,2,10,6,6,1167,0,8,1175,0
13,505,52,466,3,7,1,0,10,4,1048,0,10,1058,0
14,502,14,399,13,9,2,4,6,5,954,0,21,975,0
15,229,17,327,7,6,0,8,8,4,606,0,7,613,0
16,79,7,419,8,5,2,4,13,1,538,0,4,542,0
17,307,57,441,6,6,2,2,9,9,839,0,13,852,0
18,392,30,564,7,3,5,10,16,2,1029,0,20,1049,0
19,354,44,307,12,24,4,6,8,4,763,0,19,782,0
20,274,27,411,5,8,4,11,       IS,6,764,0,14,778,0
21,217,21,455,10,1,2,4,8,2,720,0,7,727,0
22,228,15,471,7,6,3,9,11,2,752,0,13,765,0
23,171,18,507,3,8,1,1,12,4,725,0,8,733,0
24,81,25,676,6,10,1,7,15,4,825,0,3,828,0
25,399,14,262,6,4,1,4,20,9,719,0,10,729,0
26,16,24,680,3,2,0,0,3,0,728,0,2,730,0
27,5,1,786,2,2,1,1,1,0,799,0,0,799,0
28,254,37,483,6,12,6,3,10,3,814,0,8,822,0
29,40,31,949,4,8,1,3,0,1,1037,0,1,1038,0
30,29,36,895,4,8,2,0,9,3,986,0,4,990,0
31,9,2,790,0,1,0,0,5,2,809,0,1,810,0
32,234,57,329,16,15,9,11,8,11,690,0,17,707,0
33,349,34,422,5,15,7,3,2,5,842,0,12,854,0
34,286,17,490,10,9,2,2,10,3,829,0,12,841,0
35,209,19,376,6,6,3,1,6,5,631,0,4,635,0
36,411,31,417,7,9,2,6,14,5,902,0,10,912,0
37,206,24,338,9,18,0,1,4,1,601,0,6,607,0
38,11,39,590,9,5,1,2,8,2,667,0,3,670,0
39,15,36,571,3,4,2,1,5,2,639,0,3,642,0
40,387,19,474,8,4,2,4,7,1,906,0,7,913,0
41,536,43,443,8,16,6,2,13,8,1075,0,17,1092,0
42,208,8,417,8,10,0,4,10,1,666,0,6,672,0
43,258,39,379,5,4,1,4,4,1,695,0,4,699,0
44,25,32,666,2,7,1,4,10,1,748,0,1,749,0
45,24,11,584,6,13,0,2,24,2,666,0,5,671,0
46,3,5,561,1,1,0,0,7,1,579,0,3,582,0
47,4,25,715,4,4,1,3,11,0,767,0,5,772,0
48,17,29,1038,14,10,1,2,11,1,1123,0,1,1124,0
49,16,29,1123,11,26,5,4,22,4,1240,0,12,1252,0
50,20,20,934,2,9,1,3,2,1,992,0,2,994,0
51,32,19,1049,1,4,1,2,13,2,1123,0,4,1127,0
52,10,24,690,5,5,3,0,8,1,746,0,4,750,0
53,15,10,689,6,4,1,2,11,1,739,0,1,740,0
54,8,8,745,4,4,1,0,9,1,780,0,0,780,0
55,26,49,1069,5,4,3,5,23,3,1187,0,9,1196,0
56,337,26,438,5,9,3,6,22,3,849,0,19,868,0
57,323,20,369,7,8,10,5,12,7,761,0,14,775,0
58,18,98,893,10,22,5,4,13,2,1065,0,5,1070,0
59,12,71,601,3,8,1,0,6,1,703,0,3,706,0
60,88,25,677,13,7,3,2,19,5,839,0,11,850,0
61,79,10,373,3,2,4,2,4,3,480,0,1,481,0
62,17,55,621,7,11,0,0,4,0,715,0,3,718,0
63,151,11,433,3,5,3,2,8,1,617,0,4,621,0
64,19,51,467,7,5,2,0,5,3,559,0,2,561,0
65,415,20,393,4,5,2,1,1,2,843,0,5,848,0
66,      Â· 30,64,625,5,19,4,3,4,2,756,0,4,760,0
67,33,15,675,10,6,1,0,6,1,747,0,0,747,0
68,91,39,566,5,7,0,1,6,1,716,0,7,723,0
69,142,21,438,8,6,1,8,28,3,655,0,12,667,0
70,107,81,998,11,24,1,1,12,2,1237,0,9,1246,0
71,56,26,673,5,6,2,2,6,0,776,0,4,780,0
72,73,22,672,7,7,2,4,3,2,792,0,4,796,0
73,232,17,334,5,6,1,7,2,3,607,0,5,612,0
74,194,11,394,4,2,2,2,8,1,618,0,4,622,0
75,109,5,212,1,3,6,290,2,6,634,0,10,644,0
76,375,13,403,9,2,1,3,9,4,819,0,9,828,0
77,229,8,373,2,4,2,2,5,3,628,0,10,638,0
78,171,7,436,8,10,1,3,6,3,645,0,9,654,0
79,128,6,421,3,62,0,1,4,3,628,0,6,634,0
80,7,50,466,2,6,1,2,2,0,536,0,5,541,0
81,12,170,604,1,4,0,0,1,3,795,0,1,796,0
82,80,190,568,2,10,1,1,5,2,859,0,3,862,0
83,333,147,421,5,16,4,6,4,1,937,0,8,945,0
84,424,66,398,3,2,6,1,5,1,906,0,16,922,0
85,363,28,225,6,9,7,0,3,0,641,0,8,649,0
86,295,83,218,3,29,2,3,2,1,636,0,4,640,0
87,543,12,284,2,2,0,3,5,0,851,0,16,867,0
88,503,62,386,2,8,1,0,5,1,968,0,5,973,0
89,451,19,322,11,4,8,4,4,0,823,0,5,828,0
90,516,9,533,6,4,3,0,15,0,1086,0,7,1093,0
91,164,14,252,5,75,6,13,10,1,540,0,6,546,0
92,371,53,258,11,7,5,2,5,0,712,0,14,726,0
93,27,268,623,5,37,4,2,14,3,983,0,1,984,0
94,370,87,396,5,7,2,2,1,4,874,0,16,890,0
95,296,35,336,8,15,2,3,4,6,705,0,5,710,0
96,508,18,413,5,4,1,0,16,8,973,0,15,988,0
97,380,31,213,1,1,1,0,9,3,639,0,8,647,0
98,497,17,276,6,4,3,3,4,3,813,0,12,825,0
99,364,15,225,8,3,2,5,10,1,633,0,5,638,0
100,310,139,387,7,9,9,1,13,5,880,0,9,889,0
101,356,29,70,3,6,3,1,4,2,474,0,8,482,0
102,349,17,269,7,5,1,0,9,3,660,0,15,675,0
103,298,21,270,5,0,0,2,4,2,602,0,9,611,0
104,497,51,306,7,15,1,2,0,6,885,0,15,900,0
105,71,45,575,9,14,3,2,5,2,726,0,3,729,0
107,393,61,196,2,1,0,2,0,2,657,0,12,669,0
108,342,36,200,3,9,6,0,8,4,608,0,10,618,0
109,569,35,428,2,11,2,3,6,4,1060,0,13,1073,0
110,414,89,164,1,6,0,2,0,1,677,0,6,683,0
111,683,90,389,6,9,5,3,2,4,1191,0,19,1210,0
112,437,18,420,9,4,2,0,12,4,906,0,11,917,0
114,336,85,587,9,6,0,1,11,3,1038,0,5,1043,0
115,416,27,227,7,2,0,3,8,6,696,0,10,706,0
116,183,3,136,2,2,0,2,3,2,333,0,6,339,0
117,565,34,256,4,32,2,2,2,1,898,0,8,906,0
118,311,82,255,6,5,4,5,4,5,677,0,6,683,0
119,441,155,86,0,2,1,2,1,4,692,0,6,698,0
120,512,30,187,6,3,2,1,3,5,749,0,15,764,0
121,483,31,222,3,16,2,1,4,3,765,0,7,772,0
122,375,7,226,5,10,1,2,4,1,631,0,7,638,0
123,720,54,325,0,12,3,3,6,6,1129,0,16,1145,0
124,142,55,470,5,2,0,1,5,0,680,0,2,682,0
125,590,20,84,2,5,1,2,2,2,708,0,9,717,0
126,586,84,471,9,13,5,3,7,4,1182,0,14,1196,0
127,688,39,241,4,5,2,3,9,1,992,0,15,1007,0
128,166,8,160,4,3,0,0,5,1,347,0,9,356,0
129,391,43,538,11,3,3,7,8,2,1006,0,4,1010,0
130,490,10,298,2,5,1,2,11,1,820,0,7,827,0
131,454,9,114,5,7,0,2,0,3,594,0,6,600,0
132,494,17,325,5,8,6,5,5,4,869,0,16,885,0
133,426,15,277,6,3,4,2,3,4,740,0,13,753,0
134,452,212,186,4,3,3,2,4,7,873,0,11,884,0
135,206,45,182,1,0,1,0,1,2,438,0,7,445,0
136,495,34,361,6,8,3,3,6,2,918,0,14,932,0
137,262,16,127,1,5,1,0,0,1,413,0,7,420,0
138,615,19,319,13,4,3,0,7,7,987,0,12,999,0
139,448,51,190,0,3,1,3,1,3,700,0,11,711,0
140,359,42,312,1,11,2,0,3,2,732,0,12,744,0
141,391,38,382,2,7,4,5,3,1,833,0,10,843,0
142,63,105,476,5,9,2,0,2,4,666,0,8,674,0
143,446,32,292,1,16,0,0,0,0,787,0,2,789,0
144,122,5,55,0,8,0,0,0,0,190,0,1,191,0
145,363,29,226,5,8,2,5,3,3,644,0,10,654,0
146,310,204,98,1,11,1,0,2,5,632,0,5,637,0
147,252,2,165,4,2,5,0,3,0,433,0,4,437,0
148,284,48,495,5,5,3,3,19,6,868,0,20,888,0
149,19,43,744,2,20,1,3,4,1,837,0,4,841,0
150,314,88,524,8,24,3,2,21,11,995,0,19,1014,0
151,287,20,72,1,4,4,0,1,3,392,0,5,397,0
152,468,8,237,8,2,1,6,13,4,747,0,21,768,0
153,359,20,217,4,6,4,0,1,3,614,0,10,624,0
154,634,36,307,5,16,0,1,5,2,1006,0,14,1020,0
155,377,41,167,7,4,2,2,0,6,606,0,13,619,0
156,395,54,126,2,26,3,0,0,1,607,0,5,612,0
157,675,92,286,7,20,0,6,10,1,1097,0,15,1112,0
158,336,19,81,1,4,2,0,1,0,444,0,11,455,0
159,458,62,232,0,8,3,3,4,8,778,0,14,792,0
160,680,39,293,11,6,4,2,9,4,1048,0,9,1057,0
161,538,40,289,11,18,1,1,1,4,903,0,12,915,0
162,270,10,213,2,3,2,0,0,1,501,0,5,506,0
163,508,40,265,6,2,2,3,3,1,830,0,8,838,0
164,331,97,298,4,0,2,1,2,2,737,0,9,746,0
165,488,237,257,2,6,2,3,3,3,1001,0,5,1006,0
166,399,94,227,10,11,9,1,2,4,757,0,5,762,0
167,368,273,257,3,4,3,5,5,9,927,0,12,939,0
169,256,145,210,6,9,7,6,7,2,648,0,7,655,0
170,651,88,263,5,9,2,5,4,4,1031,0,12,1043,0
171,519,36,259,7,2,1,4,3,11,842,0,8,850,0
172,504,31,284,12,12,2,3,6,4,858,0,12,870,0
173,443,27,370,5,5,2,2,5,2,861,0,10,871,0
174,663,40,272,6,6,2,4,10,5,1008,0,13,1021,0
175,587,24,444,6,11,2,4,3,2,1083,0,7,1090,0
176,395,30,326,4,3,1,5,6,0,770,0,11,781,0
177,393,10,196,4,1,0,1,3,1,609,0,7,616,0
178,515,13,264,8,1,4,5,8,2,820,0,12,832,0
179,381,16,77,3,4,0,2,3,3,489,0,5,494,0
180,473,33,234,7,9,6,0,5,8,775,0,12,787,0
181,425,10,232,7,3,0,1,5,2,685,0,10,695,0
182,574,29,254,10,8,3,4,13,5,900,0,16,916,0
183,425,52,425,14,20,5,6,14,13,974,0,29,1003,0
184,379,44,438,3,5,4,5,7,3,888,0,24,912,0
185,382,13,189,3,8,2,1,5,1,604,0,13,617,0
186,464,46,454,3,3,2,3,3,3,981,0,8,989,0
187,240,42,161,1,2,1,1,0,4,452,0,5,457,0
188,584,111,258,3,8,2,1,6,9,982,0,15,997,0
189,503,115,382,3,8,2,2,4,1,1020,0,8,1028,0
190,326,50,240,1,14,1,3,4,2,641,0,6,647,0
191,233,30,163,2,2,0,0,0,1,431,0,2,433,0
192,611,80,165,3,12,1,3,3,3,881,0,15,896,0
193,553,46,339,3,33,6,4,4,6,994,0,24,1018,0
194,456,95,229,1,24,2,4,0,1,812,0,6,818,0
195,216,21,121,1,5,1,2,2,0,369,0,4,373,0
196,281,45,419,3,16,3,1,9,6,783,0,17,800,0
197,296,19,223,4,2,4,1,2,1,552,0,7,559,0
198,180,11,242,5,5,2,1,2,2,450,0,6,456,0
199,245,20,148,4,1,2,1,1,2,424,0,6,430,0
200,377,112,209,6,3,1,0,4,2,714,0,9,723,0
201,309,46,342,7,7,5,5,11,4,736,0,18,754,0
202,492,40,443,17,3,1,3,2,1,1002,0,9,1011,0
203,700,25,296,2,11,0,1,1,0,1036,0,6,1042,0
204,569,26,81,2,8,0,1,1,1,689,0,5,694,0
205,282,7,54,0,8,1,1,2,3,358,0,3,361,0
206,208,21,95,1,5,0,2,2,4,338,0,3,341,0
207,209,5,25,0,1,0,0,0,0,240,0,3,243,0
208,311,5,24,1,14,0,0,0,0,355,0,3,358,0
209,137,8,51,0,2,0,0,0,0,198,0,0,198,0
210,302,1,31,2,14,1,0,1,1,353,0,2,355,0
211,149,7,11,1,2,1,0,0,0,171,0,4,175,0
212,409,38,71,1,11,0,1,3,0,534,0,1,535,0
213,724,32,110,0,11,1,3,1,5,887,0,6,893,0
214,611,43,371,7,15,8,6,8,9,1078,0,12,1090,0
215,427,15,431,6,7,3,2,9,7,907,0,11,918,0
216,625,47,278,8,15,1,44,2,3,1023,0,18,1041,0
217,420,21,351,9,12,4,1,6,4,828,0,20,848,0
218,228,13,252,6,1,1,4,6,3,514,0,13,527,0
219,421,48,321,7,13,0,1,4,4,819,0,19,838,0
220,305,23,393,6,2,1,1,3,2,736,0,10,746,0
221,476,63,346,5,5,3,2,8,2,910,0,29,939,0
222,298,18,375,5,2,4,1,7,3,713,0,8,721,0
223,429,22,208,2,7,2,2,0,2,674,0,4,678,0
224,622,34,465,8,6,8,0,5,4,1152,0,15,1167,0
225,629,17,448,7,6,2,5,8,4,1126,0,12,1138,0
226,493,16,322,7,6,2,2,2,3,853,0,9,862,0
227,473,28,239,6,4,2,2,4,3,761,0,11,772,0
228,402,5,339,4,2,1,1,5,2,761,0,10,771,0
229,448,111,360,4,3,3,2,5,2,938,0,12,950,0
230,201,13,266,8,2,2,1,4,2,499,0,2,501,0
231,346,15,447,7,5,0,2,6,1,829,0,11,840,0
232,402,18,217,3,12,0,1,2,0,655,0,2,657,0
234,420,21,405,6,9,1,0,4,0,866,0,9,875,0
235,441,25,371,5,8,1,3,7,3,864,0,7,871,0
238,501,10,384,9,11,3,4,5,3,930,0,12,942,0
239,248,4,210,7,16,5,1,3,5,499,0,12,511,0
240,315,27,495,6,13,2,0,4,4,866,0,8,874,0
241,316,25,342,7,12,6,3,8,5,724,0,16,740,0
242,249,22,184,3,2,0,0,3,0,463,0,8,471,0
243,271,30,397,5,5,4,0,2,0,714,0,6,720,0
1,508,14,318,4,3,0,1,4,5,857,0,11,868,0
2,255,9,320,3,6,1,3,11,4,612,0,9,621,0
3,223,13,463,9,8,4,0,5,4,729,0,6,735,0
4,392,25,384,9,5,2,0,4,2,823,0,6,829,0
5,350,6,453,3,1,1,2,1,3,820,0,2,822,0
6,416,12,272,5,6,1,1,3,1,717,0,3,720,0
7,193,19,200,1,4,0,0,3,0,420,0,2,422,0
8,290,16,264,4,1,2,2,4,3,586,0,6,592,0
9,335,9,294,3,2,1,1,3,5,653,0,8,661,0
10,509,22,231,4,2,1,2,6,2,779,0,18,797,0
11,456,44,201,3,0,1,3,5,0,713,0,5,718,0
12,828,29,220,7,7,2,2,5,4,1104,0,11,1115,0
13,449,22,370,1,7,5,0,2,3,859,0,5,864,0
14,215,11,174,0,1,0,0,2,1,404,0,5,409,0
15,376,24,165,2,0,0,1,3,1,572,0,4,576,0
16,156,74,607,2,42,4,1,5,3,894,0,4,898,0
17,639,46,278,2,6,2,1,6,0,980,0,15,995,0
18,416,22,501,9,7,0,0,8,4,967,0,8,975,0
19,342,26,404,5,9,0,1,5,2,794,0,9,803,0
20,310,18,318,1,6,0,5,5,0,663,0,10,673,0
21,211,28,206,1,6,0,2,8,1,463,0,7,470,0
22,190,9,272,3,7,0,1,3,1,486,0,5,491,0
23,583,28,363,6,14,1,3,10,6,1014,0,12,1026,0
24,214,15,424,4,6,1,0,7,0,671,0,6,677,0
25,374,23,368,7,2,3,3,18,7,805,0,9,814,0
26,321,19,490,4,8,2,0,8,2,854,0,5,859,0
27,358,25,726,4,0,2,3,14,5,1137,0,18,1155,0
28,326,35,553,10,5,6,5,10,4,954,0,7,961,0
29,117,11,806,4,1,2,2,14,3,960,0,3,963,0
30,554,25,484,4,6,1,5,9,2,1090,0,18,1108,0
31,345,21,164,1,3,0,2,13,2,551,0,13,564,0
32,313,21,333,6,7,2,2,8,5,697,0,13,710,0
33,424,14,284,1,0,1,1,7,4,736,0,6,742,0
34,592,41,549,15,6,6,2,14,9,1234,0,17,1251,0
35,626,49,276,13,4,3,6,6,4,987,0,22,1009,0
36,344,13,422,3,4,1,2,16,4,809,0,14,823,0
37,384,75,295,1,7,1,0,1,1,765,0,5,770,0
38,152,96,224,8,4,2,0,5,6,497,0,7,504,0
39,541,27,328,7,4,5,4,10,3,929,0,17,946,0
40,686,21,271,4,12,4,4,6,3,1011,0,9,1020,0
41,674,44,415,7,10,6,2,9,6,1173,0,13,1186,0
42,439,40,549,18,10,11,7,26,10,1110,0,22,1132,0
43,477,71,504,7,9,7,3,4,3,1085,0,18,1103,0
44,433,85,387,6,8,14,4,3,6,946,0,10,956,0
45,334,28,496,5,1,2,1,3,6,876,0,17,893,0
46,376,40,413,3,4,3,3,4,1,847,0,8,855,0
47,368,11,345,1,5,0,1,2,1,734,0,2,736,0
48,398,41,629,16,2,9,4,8,8,1115,0,19,1134,0
49,365,38,267,4,2,2,0,3,1,682,0,16,698,0
50,524,27,269,8,4,4,3,6,9,854,0,24,878,0
51,317,19,485,2,4,1,2,3,6,839,0,5,844,0
52,187,7,331,1,0,2,2,5,3,538,0,5,543,0
53,265,10,343,0,5,1,1,7,0,632,0,9,641,0
54,387,23,298,5,6,7,3,8,3,740,0,16,756,0
55,464,34,505,13,6,6,9,18,5,1060,0,26,1086,0
56,427,6,209,0,7,1,2,7,3,662,0,8,670,0
57,383,7,228,2,3,0,0,7,3,633,0,2,635,0
58,502,14,349,7,2,1,3,4,8,890,0,14,904,0
59,389,28,342,3,9,6,2,1,4,784,0,13,797,0
60,325,26,199,1,0,1,0,0,3,555,0,3,558,0
61,352,15,194,1,8,3,1,0,2,576,0,13,589,0
62,754,39,321,6,9,6,3,9,10,1157,0,28,1185,0
63,478,15,507,5,2,3,4,7,4,1025,0,18,1043,0
64,447,12,373,8,4,1,0,1,3,849,0,8,857,0
65,245,7,384,1,6,2,1,10,1,657,0,12,669,0
66,179,13,346,2,10,2,1,6,2,561,0,12,573,0
67,610,17,438,9,2,1,7,6,1,1091,0,9,1100,0
68,291,17,507,11,5,1,1,6,2,841,0,4,845,0
69,296,11,330,3,2,4,1,16,1,664,0,1,665,0
70,273,5,292,2,1,1,0,0,0,574,0,3,577,0
71,427,27,427,8,4,1,1,3,1,899,0,8,907,0
72,435,12,334,5,4,6,3,4,1,804,0,9,813,0
73,315,8,285,4,5,2,0,7,0,626,0,11,637,0
74,275,9,234,7,5,3,1,6,5,545,0,5,550,0
75,365,27,457,1,10,3,4,11,3,881,0,9,890,0
76,336,69,349,9,6,4,5,14,9,801,0,9,810,0
77,337,17,423,6,7,1,7,7,4,809,0,12,821,0
78,398,26,484,6,6,3,3,5,5,936,0,6,942,0
79,899,34,227,3,6,3,3,4,5,1184,0,25,1209,0
80,660,22,464,11,2,2,3,7,5,1176,0,25,1201,0
81,399,9,244,1,3,0,6,1,0,663,0,5,668,0
82,390,16,228,0,2,0,0,3,0,639,0,1,640,0
83,287,32,391,7,4,5,1,1,2,730,0,15,745,0
84,566,7,410,7,7,4,4,5,3,1013,0,17,1030,0
85,553,21,453,5,1,4,4,5,1,1047,0,13,1060,0
86,392,14,400,5,3,1,8,6,1,830,0,8,838,0
87,369,17,376,4,3,1,7,9,0,786,0,12,798,0
88,336,4,295,6,1,3,1,3,3,652,0,6,658,0
89,589,13,402,8,2,2,12,1,2,1031,0,6,1037,0
90,447,15,398,3,2,0,3,1,4,873,0,13,886,0
91,182,5,308,8,1,1,15,1,3,524,0,6,530,0
92,368,12,320,9,2,4,5,5,4,729,0,9,738,0
93,357,12,314,9,3,5,3,4,2,709,0,10,719,0
94,668,15,371,11,6,2,7,8,8,1096,0,19,1115,0
95,277,5,166,2,0,0,2,1,0,453,0,6,459,0
96,314,24,154,0,3,2,5,2,4,508,0,7,515,0
97,287,3,62,2,0,0,4,0,1,359,0,3,362,0
98,342,15,224,2,3,0,0,2,0,588,0,3,591,0
99,234,20,224,1,0,0,2,1,1,483,0,7,490,0
100,261,8,397,2,3,1,5,4,3,684,0,6,690,0
101,602,15,467,6,8,2,7,4,4,1115,0,15,1130,0
102,174,20,469,11,6,4,6,10,2,702,0,5,707,0
103,423,19,381,5,3,4,3,14,6,858,0,18,876,0
104,490,19,421,9,7,1,3,6,3,959,0,12,971,0
105,391,15,273,5,6,5,2,4,3,704,0,6,710,0
106,664,12,287,6,5,1,1,2,0,978,0,12,990,0
107,398,15,367,3,5,1,1,2,4,796,0,4,800,0
108,672,27,316,8,5,1,2,4,2,1037,0,13,1050,0
109,231,9,305,1,2,0,1,3,1,553,0,3,556,0
110,600,24,381,9,7,2,2,5,9,1039,0,19,1058,0
111,220,59,581,12,13,7,4,13,10,919,0,14,933,0
112,463,12,206,8,4,3,0,4,4,704,0,13,717,0
113,535,44,319,12,1,5,7,9,6,938,0,11,949,0
114,585,12,464,12,4,0,5,0,1,1083,0,13,1096,0
115,762,28,292,6,14,3,3,6,5,1119,0,14,1133,0
116,372,6,376,6,2,4,1,8,3,778,0,8,786,0
117,513,31,296,3,3,0,3,4,1,854,0,6,860,0
118,436,12,360,8,3,2,9,6,4,840,0,10,850,0
119,444,13,354,7,9,1,17,6,4,855,0,12,867,0
120,308,11,206,7,0,0,6,1,3,542,0,7,549,0
121,275,17,253,5,3,4,8,10,3,578,0,11,589,0
122,233,35,412,6,7,1,2,5,2,703,0,4,707,0
123,287,52,293,3,2,3,1,2,3,646,0,3,649,0
124,281,13,238,1,3,0,13,4,1,554,0,2,556,0
125,431,5,258,1,2,1,0,5,3,706,0,6,712,0
126,270,17,240,6,11,0,3,3,1,551,0,6,557,0
127,364,23,248,2,17,1,1,5,4,665,0,7,672,0
128,442,36,333,7,8,0,3,4,0,833,0,8,841,0
129,193,6,248,2,4,1,4,6,4,468,0,5,473,0
130,541,18,292,4,13,3,1,15,2,889,0,17,906,0
131,287,33,352,3,13,1,1,13,4,707,0,10,717,0
132,724,26,312,4,14,1,4,6,3,1094,0,22,1116,0
133,519,34,511,8,6,5,4,14,0,1101,0,17,1118,0
134,453,22,410,4,7,3,6,9,2,916,0,11,927,0
135,472,19,636,11,6,2,3,11,4,1164,0,24,1188,0
136,618,43,442,6,8,0,3,5,0,1125,0,11,1136,0
137,481,45,497,4,3,3,8,11,2,1054,0,9,1063,0
138,259,161,736,7,20,5,9,24,7,1228,0,11,1239,0
139,212,12,365,4,4,1,1,10,3,612,0,5,617,0
140,372,21,471,2,4,0,1,10,0,881,0,9,890,0
141,375,18,208,2,3,1,2,13,5,627,0,9,636,0
142,577,26,463,4,4,0,5,11,4,1094,0,19,1113,0
143,431,47,297,2,7,1,2,2,4,793,0,7,800,0
144,177,11,335,0,2,0,0,2,2,529,0,2,531,0
145,212,39,276,1,14,3,2,3,2,552,0,7,559,0
146,250,45,204,1,6,1,10,4,1,522,0,12,534,1
147,22,28,549,4,11,0,0,4,1,619,0,1,620,0
148,267,33,221,0,6,0,0,2,0,529,0,2,531,0
149,215,20,333,1,14,2,3,5,0,593,0,6,599,0
150,607,52,465,4,13,3,2,6,1,1153,0,9,1162,0
151,544,39,330,4,16,2,1,2,2,940,0,6,946,0
152,163,27,718,2,24,2,3,9,1,949,0,6,955,0
153,86,34,845,6,29,2,2,14,5,1023,0,6,1029,0
154,386,18,269,5,6,3,0,9,4,700,0,6,706,0
155,371,25,303,5,8,4,6,2,1,725,0,13,738,0
156,332,60,323,3,14,2,1,2,0,737,0,9,746,0
157,207,38,313,2,29,4,0,1,2,596,0,3,599,0
158,206,13,195,0,5,0,1,0,0,420,0,3,423,0
159,333,59,268,3,7,1,2,1,0,674,0,5,679,0
160,571,66,369,8,13,2,1,5,2,1037,0,16,1053,0
161,426,72,337,5,17,1,3,0,0,861,0,13,874,0
162,463,70,254,0,16,1,1,2,0,807,0,14,821,0
163,266,11,202,1,11,1,0,0,3,495,0,5,500,0
164,339,47,293,2,10,1,4,4,2,702,0,8,710,0
165,410,26,177,3,14,2,2,1,2,637,0,6,643,0
166,417,64,353,5,21,3,3,2,1,869,0,12,881,0
167,222,49,114,0,13,1,0,1,         3  /,403,0,6,409,0
168,277,94,160,1,9,1,1,1,1,545,0,1,546,0
169,239,67,229,1,4,1,1,4,6,552,0,6,558,0
170,178,90,176,5,6,3,3,0,2,463,0,5,468,0
171,317,73,184,2,15,0,1,3,2,597,0,6,603,0
172,290,62,140,1,13,0,0,3,0,509,0,7,516,0
173,362,76,155,0,8,0,1,1,1,604,0,7,611,0
174,207,25,74,0,4,0,1,0,0,311,0,3,314,0
175,177,20,143,1,18,0,0,1,0,360,0,5,365,0
176,565,32,235,2,13,1,3,3,1,855,0,9,864,0
177,361,85,274,2,14,0,2,1,2,741,0,7,748,0
178,268,45,203,2,29,0,1,2,0,550,0,5,555,0
179,560,47,346,7,10,1,6,5,2,984,0,17,1001,0
180,476,49,306,2,19,0,2,2,0,856,0,15,871,0
181,445,62,292,0,13,1,2,2,0,817,0,13,830,0
182,416,46,283,2,17,0,7,6,0,777,0,10,787,0
183,298,49,434,3,33,2,7,5,2,833,0,7,840,0
184,333,13,192,1,18,0,4,0,1,562,0,9,571,0
185,286,27,241,4,5,1,3,6,2,575,0,7,582,0
186,387,35,353,4,6,0,3,13,3,804,0,11,815,0
187,528,29,370,5,18,3,1,16,1,971,0,21,992,0
188,74,14,404,5,14,0,0,2,0,513,0,5,518,0
189,359,14,224,4,11,1,0,4,3,620,0,16,636,0
190,322,24,379,3,32,1,7,6,1,775,0,12,787,0
191,101,12,93,1,7,0,2,1,0,217,0,4,221,0
192,106,7,233,2,11,2,1,1,0,363,0,2,365,0
193,259,68,217,2,16,1,0,2,2,567,0,6,573,0
194,318,76,210,1,19,0,2,0,0,626,0,9,635,0
195,499,50,245,2,22,0,2,0,3,823,0,14,837,0
196,209,45,156,1,12,2,2,1,0,428,0,4,432,0
197,283,43,214,1,18,0,0,4,1,564,0,3,567,0
198,233,33,164,1,26,3,0,7,0,467,0,4,471,0
199,313,22,161,0,24,0,0,0,0,520,0,4,524,0
200,420,61,176,2,20,1,1,4,2,687,0,12,699,0
201,308,45,181,3,21,5,3,0,1,567,0,5,572,0
202,61,27,813,13,32,1,6,19,4,976,0,  P,989,0
203,24,32,343,3,17,0,2,4,0,425,0,2,427,0
204,190,17,248,1,11,1,3,3,0,474,0,3,477,0
205,187,14,285,3,7,1,0,2,1,500,0,2,502,0
206,272,26,491,4,28,2,0,12,3,838,0,5,843,0
207,582,19,276,3,29,1,4,5,3,922,0,13,935,0
208,362,13,429,2,21,1,1,6,0,835,0,7,842,0
209,160,28,810,11,16,4,1,20,1,1051,0,17,1068,0
210,372,22,204,2,13,3,2,10,3,631,0,13,644,0
211,242,21,175,2,12,0,2,7,1,462,0,17,479,0
212,449,34,258,2,7,1,2,5,1,759,0,13,772,0
213,224,28,532,3,19,0,1,3,1,811,0,12,823,0
214,124,29,256,1,11,0,0,2,0,423,0,1,424,0
215,248,33,277,0,21,0,1,5,1,586,0,9,595,0
216,41,16,497,8,38,3,0,2,1,606,0,3,609,0
217,386,11,265,0,7,0,0,5,1,675,0,4,679,0
218,477,28,179,2,19,1,1,3,5,715,0,4,719,0
219,337,23,210,1,21,2,1,2,1,598,0,10,608,0
220,377,32,230,3,19,1,1,1,1,665,0,13,678,0
221,409,30,264,2,19,2,2,3,1,732,0,8,740,0
222,229,6,80,1,3,0,0,0,2,321,0,13,334,0
223,46,6,427,3,5,0,0,10,2,499,0,1,500,0
224,27,19,925,8,25,2,2,24,5,1037,0,11,1048,0
225,364,32,187,7,7,2,1,2,2,604,0,5,609,0
226,456,23,236,7,10,0,2,2,3,739,0,13,752,0
227,590,28,327,1,25,2,2,3,1,979,0,3,982,0
228,408,11,258,4,17,0,0,0,1,699,0,12,711,0
229,478,22,371,8,21,2,1,3,1,907,0,13,920,0
230,533,34,367,0,23,3,3,2,2,967,0,5,972,0
231,260,24,162,2,46,0,1,0,0,495,0,8,503,0
232,362,26,226,3,32,1,0,2,0,652,0,5,657,0
233,541,25,202,1,96,4,1,4,3,877,0,9,886,0
234,388,19,143,3,34,1,0,2,0,590,0,8,598,0
235,216,23,81,1,26,1,0,0,2,350,0,5,355,0
236,576,35,214,3,56,3,4,4,2,897,0,4,901,0
237,412,45,328,4,84,7,4,4,2,     /B90,0,21,911,0
238,454,35,170,1,40,1,3,3,2,709,0,3,712,0
239,421,42,196,1,12,4,2,1,0,679,0,10,689,0
240,505,28,246,2,20,1,1,1,2,806,0,10,816,0
241,491,22,316,7,22,0,5,8,1,872,0,9,881,0
242,431,14,122,0,8,0,1,0,0,576,0,3,579,0
243,245,45,260,4,13,1,1,2,0,571,0,2,573,0
244,365,40,155,1,8,1,3,1,3,577,0,5,582,0
245,556,45,266,4,22,2,1,1,3,900,0,12,912,0
246,361,22,280,4,83,0,3,6,5,764,0,7,771,0
247,272,15,337,4,167,2,3,4,0,804,0,6,810,0
248,184,6,155,0,65,0,0,1,0,411,0,5,416,0
249,302,17,280,2,113,0,2,0,1,717,0,6,723,0
250,378,25,367,3,34,2,4,6,1,820,0,8,828,0
251,440,22,323,6,46,1,4,1,0,843,0,15,858,0
252,354,21,313,0,26,0,3,1,1,719,0,8,727,0
253,347,14,585,3,39,0,4,12,1,1005,0,6,1011,0
254,434,45,278,5,33,2,0,1,2,800,0,7,807,0
255,327,19,158,1,36,1,3,0,0,545,0,8,553,0
256,247,35,599,7,61,2,2,7,2,962,0,9,971,0
257,103,40,577,6,76,4,2,20,1,829,0,7,836,0
258,493,36,249,5,40,2,3,3,6,837,0,11,848,0
259,478,38,233,1,31,2,1,4,1,789,0,10,799,0
260,360,14,182,3,25,1,1,3,0,589,0,9,598,0
261,311,10,117,1,22,1,0,1,1,464,0,9,473,0
262,448,84,399,3,12,3,6,6,2,963,0,11,974,0
263,416,61,182,1,6,3,2,24,3,698,0,22,720,0
264,537,168,201,3,5,5,3,3,6,931,0,17,948,0
265,249,76,148,2,14,1,2,9,0,501,0,11,512,0
266,289,127,100,7,14,6,5,5,9,562,0,13,575,0
267,469,87,195,4,21,0,0,1,0,777,0,13,790,0
268,526,66,129,2,11,6,0,4,4,748,0,9,757,0
269,308,44,108,2,1,0,1,2,2,468,0,3,471,0
270,373,85,186,4,6,1,2,4,3,664,0,7,671,0
271,668,141,192,2,7,4,6,2,3,1025,0,16,1041,0
272,727,94,119,4,7,1,3,2,5,962,0,16,978,0
273,279,27,68,1,2,0,1,5,1,384,0,14,398,0
274,390,95,191,1,10,1,2,2,2,694,0,10,704,0
275,660,82,271,5,9,0,4,11,6,1048,0,14,1062,0
276,562,53,293,9,9,2,3,4,3,938,0,12,950,0
277,279,74,140,0,2,1,0,0,0,496,0,5,501,0
278,547,75,194,5,10,3,4,1,0,839,0,12,851,0
279,303,78,112,3,2,0,1,0,1,500,0,4,504,0
280,415,57,136,7,8,0,3,0,2,628,0,9,637,0
281,272,30,195,1,15,0,1,0,0,514,0,4,518,0
282,500,37,379,3,6,0,0,1,1,927,0,11,938,0
283,285,34,211,0,10,0,0,0,1,541,0,6,547,0
284,354,62,224,6,16,0,3,2,2,669,0,10,679,0
285,111,15,189,1,9,1,2,1,0,329,0,2,331,0
286,244,32,388,2,9,3,1,3,1,683,0,8,691,0
287,428,56,306,2,18,0,5,2,1,818,0,10,828,0
288,285,59,193,4,20,4,6,3,3,577,0,12,589,0
289,218,51,157,0,16,0,1,0,0,443,0,11,454,0
290,333,113,186,2,11,0,3,1,0,649,0,13,662,0
291,179,43,147,0,5,1,1,0,0,376,0,8,384,0
292,272,44,214,2,7,0,5,0,0,544,0,7,551,0
293,282,68,220,1,10,2,4,6,0,593,0,5,598,0
294,338,62,227,0,22,0,5,1,0,655,0,13,668,0
295,505,72,144,1,9,0,1,3,2,737,0,18,755,0
296,268,38,192,3,11,0,2,0,0,514,0,9,523,0
297,142,44,627,8,22,3,7,9,1,863,0,5,868,0
298,41,21,317,4,10,1,1,3,1,399,0,0,399,0
299,578,47,130,2,3,0,1,3,9,773,0,26,799,0
300,40,31,501,6,17,2,3,13,2,615,0,6,621,0
