Serial No. Of Polling Station,AGARWAL KANAIALAL,CHURKA iVIURMU,DEEPA DASMUNSi,DEBASREE CHAUDHUR 1,MD. SALIM,AKIK HOSSAIN CHOWDHU RY,UKSHMA N MURMU,SANTHAPA N HASDAK,SUJAN KRISHNA PAUL,ADVOCATE ANJAY DEBSARMA,KUMARESH SARKAR,BINOY KUMAR DAS,MD. SAHAJAN BADSHA,RAJU PAUL,Total valid votes,No. of rejected votes,NOTA,Total Votes,Unnamed: 20
1,217,8,4,322,4,0,0,0,0,1,0,4,3,3,566,0,3,569,
2,95,2,8,277,24,0,0,3,0,1,0,3,0,1,414,0,1,415,
3,443,2,51,144,217,5,6,2,2,2,1,3,7,4,889,0,34,923,
4,800,1,10,5,35,1,0,0,0,0,0,1,0,0,853,0,0,853,
5,592,5,192,9,26,1,2,2,1,0,1,3,5,4,843,0,21,864,
6,122,2,39,478,78,2,2,0,3,1,1,3,6,2,739,0,7,746,
7,264,1,1,12,134,1,0,0,0,0,1,2,2,3,421,0,7,428,
8,479,0,56,207,153,1,0,2,1,1,3,7,2,3,915,0,14,929,
9,130,1,10,628,57,0,1,2,0,2,1,11,2,0,845,0,9,854,
10,456,1,57,97,196,3,1,1,1,0,3,2,2,2,822,0,12,834,
11,240,1,8,348,17,0,3,3,2,1,1,7,3,1,635,0,11,646,
12,28,0,6,483,4,1,3,1,0,0,0,6,1,1,534,0,1,535,
13,638,2,15,11,168,1,0,0,1,1,2,2,0,1,842,0,16,858,
14,701,10,240,14,106,1,2,0,0,0,2,4,5,1,1086,0,7,1093,
15,115,1,43,793,29,3,3,0,1,2,2,10,3,2,1007,0,8,1015,
16,317,7,155,205,112,4,3,6,0,2,6,9,9,8,843,0,14,857,
17,531,4,130,126,176,2,5,1,0,3,2,6,5,1,992,0,27,1019,
18,458,6,44,27,365,12,8,5,2,2,5,4,4,3,945,0,17,962,
19,580,3,78,5,180,0,0,0,0,0,0,3,5,0,854,0,17,871,
20,573,5,89,47,152,2,3,1,2,1,1,0,0,0,876,0,3,879,
21,238,0,45,442,39,0,4,0,1,1,1,3,4,1,779,0,8,787,
22,90,5,7,474,4,0,0,1,0,1,2,3,1,0,588,0,4,592,
23,110,3,18,580,10,1,1,0,1,1,2,7,3,2,739,0,7,746,
24,105,4,18,963,9,1,3,1,2,5,5,8,5,3,1132,0,9,1141,
25,99,1,12,631,16,0,2,1,1,1,6,5,1,1,777,0,3,780,
26,686,3,76,9,57,1,0,0,0,0,0,1,3,1,837,0,9,846,
27,401,3,50,9,35,1,1,1,0,1,0,1,1,0,504,0,6,510,
28,406,5,320,22,239,2,2,1,0,4,1,3,7,1,1013,0,16,1029,
29,362,0,20,310,39,0,3,2,0,0,1,4,3,0,744,0,9,753,
30,723,4,84,106,174,1,3,2,0,2,4,3,3,2,1111,0,19,1130,
31,469,8,283,107,132,2,5,0,0,2,2,2,7,1,1020,0,25,1045,
32,197,1,21,2,83,0,1,1,0,0,0,0,1,0,307,0,4,311,
33,878,1,3,6,5,0,0,1,0,0,0,0,0,0,894,0,1,895,
34,708,2,6,1,7,0,1,0,1,0,0,1,1,2,730,0,3,733,
35,534,2,5,0,4,0,0,1,1,0,0,0,0,0,547,0,2,549,
36,1100,1,7,9,14,0,0,0,0,0,0,0,0,0,1131,0,1,1132,
37,508,11,47,180,164,4,1,4,1,2,2,5,2,9,940,0,27,967,
38,986,3,6,1,11,0,0,0,0,0,0,0,0,1,1008,0,2,1010,
39,1032,2,6,4,16,0,1,0,0,0,0,0,0,0,1061,0,1,1062,
40,184,2,70,12,153,5,2,3,0,2,4,3,3,2,445,0,16,461,
41,277,6,75,25,109,3,0,2,1,2,4,4,7,0,515,0,19,534,
42,824,1,36,7,73,0,1,1,0,0,1,1,0,0,945,0,4,949,
43,570,1,56,4,142,1,0,0,0,0,0,0,1,0,775,0,3,778,
44,437,1,7,6,109,0,0,0,0,0,0,1,1,2,564,0,21,585,
45,583,1,7,2,37,0,0,0,0,0,0,1,1,1,633,0,2,635,
46,902,1,7,4,4,0,0,0,0,0,0,0,0,0,918,0,0,918,
47,616,1,54,4,174,3,0,0,0,0,1,0,1,0,854,0,7,861,
48,142,0,46,5,107,4,0,0,0,2,0,2,2,3,313,0,11,324,
49,539,0,8,8,17,0,1,1,0,0,0,1,3,2,580,0,2,582,
50,532,0,10,4,56,0,0,0,0,0,0,0,0,0,602,0,1,603,
51,363,1,16,7,312,3,0,0,1,2,1,0,1,2,709,0,7,716,
52,615,4,6,3,14,0,0,2,0,0,0,0,0,0,644,0,4,648,
53,942,1,9,9,15,0,                               0-,0,0,0,0,0,1,0,977,0,7,984,
54,316,2,11,13,51,2,0,0,0,0,2,1,0,0,398,0,12,410,
55,605,7,38,62,101,0,2,2,1,1,2,1,3,3,828,0,6,834,
56,589,6,83,47,215,5,1,0,1,0,1,1,1,3,953,0,7,960,
57,171,2,13,103,134,2,4,2,0,1,2,1,1,0,436,0,4,440,
58,337,4,59,12,340,11,2,3,3,0,0,2,1,2,776,0,9,785,
59,80,1,5,384,17,2,0,0,2,3,2,4,3,1,504,0,1,505,
60,603,4,90,87,83,0,3,0,0,0,1,4,3,2,880,0,4,884,
61,235,3,4,393,63,2,5,4,0,2,2,4,2,0,719,0,10,729,
62,470,1,23,231,276,3,1,0,1,0,0,7,3,0,1016,0,6,1022,
63,117,2,3,516,10,0,3,0,1,1,2,10,3,0,668,0,5,573,
64,130,1,6,472,4,0,1,0,1,1,0,12,5,0,633,0,5,638,
65,258,0,2,397,5,0,2,0,1,1,0,5,7,2,680,0,18,698,
66,235,3,5,563,21,0,1,1,2,8,1,17,10,1,868,0,13,881,
67,332,2,8,452,5,0,2,0,1,1,1,13,5,3,825,0,17,842,
68,302,8,10,241,55,1,1,2,2,2,1,6,2,1,634,0,11,645,
69,215,4,7,328,10,0,1,0,10,4,3,2,1,3,588,0,3,591,
70,178,6,27,622,4,0,1,3,5,1,4,11,3,5,870,0,15,885,
71,391,1,26,420,38,1,1,0,22,7,0,2,6,0,915,0,8,923,
72,308,3,5,484,11,1,2,1,7,2,2,7,6,0,839,0,5,844,
73,260,3,1,434,3,0,3,1,1,2,3,11,7,0,729,0,7,736,
74,554,6,9,248,59,2,1,0,2,3,2,4,6,1,897,0,19,916,
75,132,4,9,861,67,4,7,3,1,2,3,6,3,1,1103,0,8,1111,
76,325,2,15,571,71,1,5,2,2,3,3,9,5,2,1016,0,18,1034,
77,103,1,13,342,439,5,1,4,3,6,5,9,3,2,936,0,6,942,
78,273,3,16,840,14,2,4,9,5,5,2,14,10,4,1201,0,11,1212,
79,384,4,12,577,67,1,3,2,1,1,1,5,3,2,1063,0,3,1066,
80,200,1,5,568,7,1,9,0,0,2,3,10,4,0,810,0,12,822,
81,787,3,18,11,162,0,0,0,0,0,0,1,0,3,985,0,4,989,
82,451,5,16,320,140,1,3,1,2,3,3,4,1,0,950,0,16,966,
83,269,0,27,5,231,2,0,1,0,0,0,0,0,0,535,0,7,542,
84,270,1,56,13,305,8,1,2,2,3,3,5,2,3,674,0,16,690,
85,596,5,21,14,438,6,1,1,3,3,0,2,5,4,1099,0,6,1105,
86,273,2,7,13,258,7,1,2,4,6,2,0,0,2,577,0,10,587,
87,123,1,16,527,25,1,1,0,0,0,0,4,1,0,699,0,2,701,
88,65,5,22,685,36,2,4,6,4,3,3,6,4,4,849,0,13,862,
89,136,1,5,633,15,1,4,2,1,1,2,7,3,1,812,0,9,821,
90,55,0,7,525,19,1,0,0,1,0,0,1,2,0,611,0,1,612,
91,51,1,15,521,84,0,1,1,7,0,0,1,0,2,684,0,1,685,
92,37,0,17,13,324,1,2,2,0,0,5,3,1,1,406,0,2,408,
93,216,1,23,298,483,4,2,3,1,1,6,4,5,3,1050,0,12,1062,
94,173,1,15,199,191,1,3,0,3,0,2,2,1,0,591,0,4,595,
95,28,0,3,9,578,7,1,0,0,1,2,4,0,3,636,0,6,642,
96,163,2,11,595,237,4,0,0,1,3,6,3,1,1,1027,0,9,1036,
97,140,3,16,908,51,0,3,0,0,0,4,16,5,1,1147,0,15,1162,
98,161,0,17,742,106,0,                          1  .,1,2,2,5,15,0,2,1054,0,11,1065,
99,165,3,25,755,50,1,1,0,2,1,5,23,1,3,1035,0,11,1046,
100,164,2,21,368,128,4,1,1,0,0,1,7,6,2,705,0,11,716,
101,139,1,38,248,336,6,1,2,0,2,3,2,3,1,782,0,25,807,
102,150,0,19,240,218,3,0,1,0,4,6,7,4,1,653,0,12,665,
103,136,3,12,373,26,0,0,0,0,2,0,6,1,1,560,0,4,564,
104,278,2,23,262,268,2,2,1,0,2,6,4,0,4,854,0,16,870,
105,75,1,11,527,46,0,0,0,2,0,6,9,0,0,677,0,4,681,
106,113,0,24,164,376,2,0,0,0,2,9,6,2,2,700,0,10,710,
107,56,1,34,442,102,2,2,3,2,1,6,6,3,0,660,0,7,667,
108,119,4,70,34,537,11,3,3,0,6,10,2,7,4,810,0,5,815,
109,129,3,16,647,44,1,4,0,1,1,1,5,1,0,853,0,5,858,
110,184,1,29,514,147,1,2,0,0,1,3,2,0,0,884,0,11,895,
111,58,1,10,929,47,2,0,2,1,0,1,16,2,2,1071,0,2,1073,
112,68,2,9,647,34,2,1,4,0,0,5,10,9,1,792,0,2,794,
113,53,1,11,863,31,0,0,0,2,1,5,14,5,1,987,0,3,990,
114,93,0,18,470,39,0,0,1,0,0,0,0,0,0,621,0,4,625,
115,74,1,10,384,36,0,0,0,1,0,0,0,2,0,508,0,0,508,
116,87,1,15,475,35,0,1,0,1,0,0,3,0,1,619,0,2,621,
117,30,1,10,290,14,0,0,0,1,0,1,1,0,1,349,0,2,351,
118,175,0,10,540,98,3,1,1,1,2,1,1,1,4,838,0,14,852,
119,85,0,10,611,71,3,0,0,0,2,0,11,1,1,795,0,4,799,
120,180,0,14,732,34,0,0,1,2,1,2,7,2,1,976,0,6,982,
121,100,0,8,434,21,1,5,0,1,0,0,4,1,2,577,0,3,580,
122,125,0,15,504,41,1,1,0,0,1,1,2,1,0,692,0,0,692,
123,74,1,7,690,14,0,1,1,0,0,1,11,2,1,803,0,0,803,
124,278,6,8,413,245,10,1,3,2,1,5,14,5,8,999,0,38,1037,
125,44,0,2,403,143,1,1,1,0,1,4,5,0,0,605,0,6,611,
126,49,0,11,615,26,1,1,0,0,0,2,12,0,0,717,0,1,718,
127,74,0,4,807,17,0,1,0,0,1,0,3,3,0,910,0,5,915,
128,78,0,13,308,31,0,0,0,1,0,1,0,0,0,432,0,3,435,
129,154,0,13,362,22,0,0,1,0,0,1,0,2,1,556,0,5,561,
130,170,1,18,326,231,0,0,0,0,2,0,1,0,0,749,0,1,750,
131,84,0,6,205,292,1,0,0,1,0,2,2,0,3,596,0,3,599,
132,92,1,8,127,236,2,0,0,0,1,4,2,0,2,475,0,7,482,
133,162,0,7,343,45,0,0,0,0,0,1,1,0,0,559,0,3,562,
134,254,4,17,373,96,2,0,1,0,1,8,7,4,3,770,0,16,786,
135,202,2,11,357,68,2,2,1,0,0,1,7,1,3,657,0,7,664,
136,134,1,34,65,363,3,1,0,1,2,7,3,2,1,617,0,7,624,
137,396,3,35,37,481,9,1,2,1,6,8,5,3,4,991,0,16,1007,
138,97,2,214,77,490,9,1,0,0,3,3,7,3,0,906,0,5,911,
139,108,2,154,417,234,4,3,2,4,2,1,4,0,3,938,0,5,943,
140,287,4,15,256,334,6,2,8,2,3,3,2,7,2,931,0,9,940,
141,236,2,38,8,254,1,2,0,1,1,0,1,1,2,547,0,11,558,
142,410,4,7,2,261,5,0,1,1,1,1,2,4,2,701,0,13,714,
143,146,2,12,242,300,6,1,1,1,3,2,3,4,2,725,0,9,734,
144,404,4,37,5,151,3,0,1,0,0,2,0,0,0,607,0,4,611,
145,377,2,13,16,204,3,1,0,0,0,2,0,0,0,618,0,8,626,
146,260,4,22,18,179,2,0,1,2,0,1,0,1,2,492,0,3,495,
147,69,7,129,429,161,2,5,2,2,2,1,4,9,3,825,0,6,831,
148,197,0,19,149,77,0,4,0,0,2,0,0,0,0,448,0,11,459,
149,161,2,13,208,362,5,2,6,1,0,0,3,6,1,770,0,12,782,
150,305,11,52,11,265,6,4,0,2,0,2,0,2,3,663,0,16,679,
151,259,0,12,89,183,2,1,2,0,2,0,2,1,2,555,0,3,558,
152,119,1,65,13,414,7,1,4,2,1,1,6,3,3,640,0,7,647,
153,264,4,42,2,270,3,2,0,0,0,0,0,1,0,588,0,9,597,
154,135,1,28,539,228,5,2,2,0,0,2,6,5,1,954,0,14,968,
155,100,3,32,303,248,6,1,4,0,6,4,3,2,4,716,0,8,724,
156,146,4,36,20,302,4,1,6,2,0,4,2,2,4,533,0,15,548,
157,182,4,130,11,340,3,2,0,1,0,0,3,3,3,682,0,7,689,
158,275,1,102,18,431,12,0,3,0,1,2,1,9,2,857,0,22,879,
159,179,3,8,7,342,5,3,2,0,0,7,0,1,3,560,0,12,572,
160,203,4,32,17,483,8,1,7,3,3,14,5,2,7,789,0,29,818,
161,171,2,18,6,118,2,2,2,0,1,1,3,0,1,327,0,12,339,
162,203,5,56,485,222,3,2,2,0,0,3,4,3,7,995,0,7,1002,
163,270,4,31,23,190,4,2,3,1,2,5,1,2,0,538,0,18,556,
164,101,2,23,7,179,4,1,1,2,0,2,1,2,1,326,0,3,329,
165,104,3,58,15,348,5,5,3,3,1,5,7,2,1,560,0,8,568,
166,114,1,36,211,187,5,1,2,2,1,4,1,5,1,571,0,8,579,
167,206,4,89,43,181,3,0,1,0,0,1,0,0,0,528,0,2,530,
168,158,3,43,11,149,4,0,2,0,1,2,1,1,1,376,0,11,387,
169,187,4,10,463,178,3,1,1,2,1,4,6,3,0,863,0,4,867,
170,88,1,9,475,202,3,1,2,1,2,2,6,1,2,795,0,6,801,
171,285,2,24,324,176,0,0,6,0,3,3,1,4,1,829,0,11,840,
172,352,4,20,14,217,4,2,0,1,2,1,0,1,0,618,0,13,631,
173,30,1,7,35,308,7,1,1,0,3,2,1,1,1,398,0,4,402,
174,300,5,11,246,302,6,5,8,3,4,7,3,10,8,918,0,30,948,
175,137,2,26,270,399,10,3,4,1,1,3,8,2,1,867,0,10,877,
176,251,2,38,29,287,4,2,2,2,1,4,0,2,0,624,0,7,631,
177,291,0,12,8,73,2,0,0,0,0,0,0,1,0,387,0,"                            13
                            6
                            7
                            10
                            17
                            4
                            8
                            0
                            6
                            12
                             1
                            19
                             1
                            15
                             8
                             1
                             5
                             8
                             6
                            12
                             3
                             2",400,
178,266,3,20,12,221,1,2,2,2,0,3,2,1,1,536,0,,542,
179,281,1,43,204,143,2,0,4,0,1,4,3,0,3,689,0,,696,
180,544,1,8,4,104,2,0,1,0,0,4,1,1,1,671,0,,681,
181,260,2,30,9,255,6,3,1,1,3,1,3,4,3,581,0,,598,
182,133,1,65,2,28,0,0,0,0,1,0,1,0,1,232,0,,236,
183,136,2,34,346,230,4,2,2,2,2,2,1,1,2,766,0,,774,
184,39,0,3,260,8,1,0,7,0,2,0,1,2,0,323,0,,323,
185,126,5,7,377,206,1,3,3,0,1,1,4,1,3,738,0,,744,
186,278,4,10,500,91,1,1,0,0,0,1,6,1,1,894,0,,906,
187,104,4,2,268,11,0,0,1,0,0,1,1,1,1,394,0,,395,
188,378,4,11,221,184,4,3,1,0,0,1,0,4,4,815,0,,834,
189,512,2,1,7,6,0,0,0,0,0,0,0,0,0,528,0,,529,
190,328,1,10,15,161,2,0,1,1,0,1,1,2,0,523,0,,538,
191,317,3,9,5,148,0,1,1,0,1,0,0,1,2,488,0,,496,
192,374,1,12,40,36,0,0,0,0,0,0,1,0,0,464,0,,465,
193,242,3,14,151,238,4,1,9,3,2,1,0,4,2,674,0,,679,
194,384,6,11,35,176,1,0,1,0,0,2,0,3,1,620,0,,628,
195,79,3,8,243,206,8,1,1,0,1,4,2,4,1,561,0,,567,
196,465,4,32,240,112,2,1,0,0,1,1,4,8,2,872,0,,884,
197,200,1,4,357,29,3,1,7,0,0,1,5,2,1,611,0,,614,
198,117,0,2,475,18,0,2,1,1,1,3,6,3,0,629,0,,631,
199,266,3,10,475,128,3,4,0,4,1,3,6,4,2,909,0,8,917,
200,182,2,8,213,26,1,1,0,2,1,0,1,0,4,441,0,7,448,
201,419,2,12,447,151,1,1,1,3,0,3,4,0,3,1047,0,11,1058,
202,230,6,4,670,64,2,2,2,0,2,2,5,2,0,991,0,13,1004,
203,295,4,8,472,23,0,1,0,1,3,2,5,4,2,820,0,6,826,
204,153,3,5,460,1,0,2,2,0,0,0,3,4,0,633,0,1,634,
205,227,2,41,                              257     1      283,,7,1,2,1,3,1,4,6,4,839,0,16,855,
206,298,1,14,92,267,6,2,0,0,0,2,5,2,5,694,0,9,703,
207,305,2,45,15,291,8,2,2,1,1,4,4,4,1,685,0,12,697,
208,251,4,10,23,228,3,1,2,1,1,2,1,1,0,528,0,6,534,
209,341,1,6,13,228,3,0,0,1,0,0,0,0,0,593,0,7,600,
210,142,0,6,617,28,0,3,0,0,1,0,4,6,1,808,0,4,812,
211,655,2,17,129,131,2,2,0,1,2,2,7,2,2,954,0,18,972,
212,18,2,2,548,16,1,0,0,1,1,1,0,1,0,591,0,1,592,
213,118,0,1,203,16,0,0,0,0,1,0,2,0,0,341,0,0,341,
214,234,0,2,577,20,0,0,1,0,1,0,5,7,0,847,0,9,856,
215,480,1,16,9,74,1,1,1,1,1,0,2,0,0,587,0,2,589,
216,392,3,12,169,83,3,3,0,1,1,0,6,1,1,675,0,9,684,
217,125,3,11,472,26,0,0,0,0,1,0,1,2,2,643,0,0,643,
1,916,6,29,64,24,1,0,0,0,1,0,1,0,0,1042,0,4,1046,0
2,192,1,113,146,134,2,4,0,0,2,1,1,4,3,603,0,9,612,0
3,270,7,66,100,145,2,3,2,3,3,4,4,5,7,621,0,13,634,0
4,442,2,127,61,158,3,1,0,0,1,1,4,3,0,803,0,6,809,0
5,231,3,3,449,12,1,2,2,0,0,1,10,3,1,718,0,10,728,0
6,195,1,27,696,13,0,2,6,0,0,2,3,2,0,947,0,9,956,0
7,357,0,9,429,27,0,0,0,0,1,1,2,0,1,827,0,8,835,0
8,83,1,10,518,24,0,1,1,0,0,1,4,3,4,650,0,3,653,0
9,372,3,34,270,348,3,5,0,1,0,6,6,1,3,1052,0,9,1061,0
10,509,2,21,73,303,3,0,3,0,0,3,2,3,3,925,0,20,945,0
11,348,4,27,61,247,3,0,2,0,1,4,2,1,2,702,0,17,719,0
12,333,1,10,35,244,0,0,1,0,0,2,1,1,0,628,0,5,633,0
13,386,4,20,118,246,2,2,0,0,2,2,10,5,4,801,0,20,821,0
14,261,2,121,72,289,0,0,1,1,1,0,2,2,1,753,0,3,756,0
15,208,1,89,120,149,3,3,3,0,3,3,5,3,3,593,0,8,601,0
16,463,2,203,82,124,0,3,1,0,0,1,3,1,2,885,0,6,891,0
17,271,1,42,135,202,1,1,0,0,1,3,1,2,0,660,0,8,668,0
18,557,4,126,125,185,1,1,0,1,0,0,1,5,0,1006,0,4,1010,0
19,284,0,75,59,207,4,0,1,0,0,0,0,0,3,633,0,7,640,0
20,212,3,44,205,105,0,0,0,0,1,2,1,5,1,579,0,11,590,0
21,125,1,56,688,70,0,2,5,0,1,0,2,3,1,954,0,10,964,0
22,581,2,49,144,164,2,1,2,2,3,2,2,1,3,958,0,19,977,0
23,387,0,122,30,196,3,2,3,2,2,0,3,3,1,754,0,9,763,0
24,388,2,70,251,120,2,3,0,1,2,5,5,2,3,854,0,10,864,0
25,642,4,62,68,205,3,2,2,1,4,8,4,3,5,1013,0,34,1047,0
26,462,7,97,233,115,1,7,1,2,9,3,4,5,1,947,0,15,962,0
27,302,4,36,88,191,3,1,2,0,2,1,1,0,1,632,0,8,640,0
28,362,5,28,21,235,4,2,2,2,0,2,2,2,2,669,0,14,683,0
29,638,4,22,18,64,0,0,0,1,1,2,1,0,4,755,0,24,779,0
30,364,4,42,337,100,0,2,1,3,4,2,5,8,3,875,0,11,886,0
31,397,3,34,27,182,4,1,0,0,1,0,1,1,1,652,0,5,657,0
32,404,1,8,199,67,0,0,0,6,2,1,1,3,2,694,0,8,702,0
33,141,2,5,345,5,2,3,0,0,0,0,4,3,1,511,0,1,512,0
34,285,0,111,189,78,1,1,1,1,0,4,1,2,1,675,0,6,681,0
35,182,2,7,247,70,2,0,1,0,1,2,2,1,0,517,0,10,527,0
36,490,4,25,46,226,5,3,0,1,1,1,1,0,0,803,0,5,808,0
37,128,10,9,806,6,0,2,1,0,2,4,11,3,0,982,0,6,988,0
38,84,11,2,463,7,0,4,0,1,0,0,3,2,0,577,0,3,580,0
39,507,5,9,244,108,4,5,0,0,2,1,4,6,1,896,0,16,912,0
40,607,10,18,210,53,1,0,3,0,1,0,1,0,0,904,0,3,907,0
41,385,5,5,60,47,2,16,4,2,2,2,1,0,0,531,0,13,544,0
42,184,3,48,377,30,1,8,0,1,2,0,5,4,2,665,0,6,671,0
43,366,1,9,471,15,0,0,0,0,1,1,2,2,1,869,0,2,871,0
44,432,7,38,95,51,3,2,2,2,2,1,0,0,1,636,0,9,645,0
45,557,3,55,34,42,0,0,1,0,0,0,1,2,1,696,0,6,702,0
46,502,6,28,17,87,0,1,1,1,1,3,1,5,4,657,0,20,677,0
47,432,3,13,10,32,0,1,1,0,0,0,1,2,0,495,0,7,502,0
48,396,3,20,11,55,0,1,1,0,1,2,2,3,2,497,0,8,505,0
49,361,5,7,55,225,2,0,0,0,2,2,0,1,1,661,0,3,664,0
50,170,0,3,16,252,2,2,1,0,0,0,2,2,1,451,0,12,463,0
51,497,2,12,39,310,1,0,1,0,2,1,1,1,1,868,0,4,872,0
52,304,2,52,558,112,0,0,2,0,2,1,2,4,0,1039,0,7,1046,0
53,386,5,3,122,33,2,1,0,0,2,0,4,1,0,559,0,5,564,0
54,362,4,57,313,250,1,2,3,1,1,5,5,2,2,1008,0,18,1026,0
55,367,5,9,46,134,0,1,3,0,2,1,1,1,3,573,0,27,600,0
56,347,5,24,19,326,4,2,1,0,1,5,0,5,4,743,0,20,763,0
57,347,2,9,19,387,3,0,1,0,2,2,3,0,1,776,0,11,787,0
58,513,1,2,6,14,0,0,0,0,1,0,0,0,1,538,0,2,540,0
59,615,4,7,23,17,2,1,0,1,0,0,0,0,1,671,0,4,675,0
60,507,6,20,12,118,0,1,0,2,2,1,4,3,5,681,0,11,692,0
61,617,3,0,8,79,0,1,0,0,0,1,1,2,1,713,0,0,713,0
62,271,6,244,28,185,4,3,3,0,1,3,3,5,2,758,0,15,773,0
63,336,5,266,11,86,2,4,1,0,0,1,4,0,1,717,0,9,726,0
64,421,6,93,38,263,1,3,4,3,6,4,1,6,4,853,0,15,868,0
65,468,3,259,10,70,1,1,2,0,2,0,0,4,2,822,0,11,833,0
66,264,1,51,240,212,8,3,3,1,3,2,2,5,8,803,0,18,821,0
67,373,3,138,15,186,5,1,1,1,2,2,2,2,3,734,0,15,749,0
68,249,2,183,20,100,4,1,3,4,3,4,1,2,0,576,0,20,596,0
69,265,4,39,5,183,1,0,3,0,0,1,0,0,1,502,0,2,504,0
70,189,1,229,6,47,0,0,0,0,0,0,1,1,0,474,0,1,475,0
71,335,1,115,10,264,1,3,0,1,1,1,0,3,2,737,0,13,750,0
72,294,1,20,44,377,1,2,6,0,5,3,2,3,3,761,0,8,769,0
73,679,2,16,13,113,0,0,0,0,2,1,2,3,2,833,0,6,839,0
74,354,6,11,151,168,1,1,0,1,1,3,4,11,5,717,0,22,739,0
75,420,2,14,45,82,2,1,1,0,1,3,0,4,1,576,0,17,593,0
76,407,4,35,8,219,5,0,4,2,0,0,4,7,3,698,0,16,714,0
77,603,1,23,19,50,0,0,0,2,0,0,1,0,0,699,0,1,700,0
78,556,5,33,24,108,0,2,0,2,1,0,1,1,0,733,0,5,738,0
79,566,4,23,13,104,3,2,3,1,0,1,1,4,1,726,0,19,745,0
80,316,3,51,26,262,6,1,2,2,1,4,1,2,4,681,0,14,695,0
81,509,1,2,18,48,1,0,0,0,2,1,1,1,1,585,0,17,602,0
82,825,0,5,2,36,0,0,0,4,0,0,1,0,0,873,0,3,876,0
114,267,3,11,18,140,3,1,2,0,1,2,0,3,1,452,0,10,462,0
115,37,2,146,5,234,3,1,2,1,1,2,3,1,2,440,0,2,442,0
116,396,6,11,133,55,1,1,0,0,0,1,1,5,1,611,0,2,613,0
117,537,7,23,207,97,4,3,1,1,4,1,5,3,3,896,0,15,911,0
118,401,2,23,17,172,4,0,0,2,0,3,1,2,0,627,0,9,636,0
119,459,3,13,20,132,1,0,1,0,1,1,0,2,1,634,0,9,643,0
120,316,4,10,196,59,2,0,0,0,4,1,3,2,2,599,0,7,606,0
121,633,7,16,44,37,0,1,0,1,0,0,1,1,2,743,0,14,757,0
122,435,3,26,21,132,1,2,2,1,0,3,2,2,5,635,0,29,664,0
123,441,5,31,69,86,2,3,0,3,3,1,3,4,1,652,0,18,670,0
124,509,1,42,128,103,4,2,2,1,1,3,2,0,3,801,0,15,816,0
125,411,2,6,9,153,2,1,1,0,0,0,0,2,0,587,0,4,591,0
126,422,0,19,32,71,1,0,3,0,3,0,1,1,1,554,0,18,572,0
127,279,2,6,5,84,0,1,2,0,0,0,1,0,2,382,0,6,388,0
128,587,3,85,147,156,1,2,3,1,4,2,1,2,2,996,0,11,1007,0
129,522,0,14,106,131,2,1,0,1,0,0,1,1,3,782,0,17,799,0
130,128,8,48,358,15,1,8,25,6,4,6,5,10,2,624,0,9,633,0
131,338,0,6,7,194,5,0,1,0,0,0,0,3,1,555,0,7,562,0
132,359,2,41,107,146,5,1,0,0,1,2,3,1,1,669,0,7,676,0
133,461,0,22,9,127,4,1,2,0,0,0,0,2,2,630,0,5,635,0
134,399,3,5,12,265,2,0,1,0,0,1,0,1,0,689,0,7,696,0
135,607,1,5,3,31,0,1,1,1,1,0,0,0,0,651,0,0,651,0
136,440,7,32,14,96,2,2,1,0,1,0,3,1,0,599,0,6,605,0
137,295,2,30,11,106,3,0,0,2,1,1,2,1,0,454,0,10,464,0
138,387,3,27,10,115,1,0,0,0,2,2,1,2,0,550,0,12,562,0
139,298,2,36,10,104,2,1,3,1,3,3,1,3,2,469,0,22,491,0
140,278,2,58,41,174,3,1,2,1,1,1,3,3,2,570,0,11,581,0
141,263,2,148,17,64,0,1,0,0,1,1,1,0,1,499,0,5,504,0
142,399,5,64,8,269,5,1,0,1,1,0,0,2,0,755,0,0,755,0
143,293,5,87,12,174,3,1,0,2,0,2,1,9,4,593,0,12,605,0
144,352,3,27,178,                           178     1     1,,1,3,1,8,2,3,5,3,765,0,9,774,0
145,246,2,39,150,115,2,1,0,2,3,3,7,2,1,573,0,11,584,0
146,400,2,88,9,46,3,1,0,0,1,2,3,2,2,559,0,23,582,0
147,315,2,15,7,48,2,1,1,0,2,2,1,1,1,398,0,18,416,0
148,278,0,39,8,227,5,0,1,1,1,2,0,2,1,565,0,10,575,0
149,351,2,24,10,140,2,0,1,0,1,3,0,3,1,538,0,13,551,0
150,408,1,51,35,157,4,1,0,9,2,1,0,1,1,671,0,4,675,0
151,535,6,23,59,82,3,0,1,0,2,1,3,4,2,721,0,6,727,0
152,860,7,9,12,64,1,0,0,0,1,0,1,0,1,956,0,2,958,0
153,338,3,186,14,137,1,2,0,0,1,3,3,0,1,689,0,9,698,0
154,252,7,101,231,37,0,0,0,1,2,0,1,5,1,638,0,13,651,0
155,255,3,77,108,72,1,3,2,0,2,3,3,3,3,535,0,7,542,0
156,237,2,34,8,165,5,2,2,1,0,0,0,1,1,458,0,7,465,0
157,454,2,28,45,231,3,0,2,1,0,0,2,2,2,772,0,10,782,0
158,529,12,44,48,215,4,5,2,1,2,2,1,0,1,866,0,8,874,0
159,337,8,27,109,41,0,1,10,10,1,2,2,3,3,554,0,14,568,0
160,215,4,34,226,46,2,3,1,1,1,1,1,0,0,535,0,5,540,0
161,629,3,23,52,65,3,2,1,1,1,1,0,3,2,786,0,8,794,0
162,618,3,11,186,78,1,0,0,1,,0,2,1,2,903,0,9,912,0
163,424,0,11,115,99,1,0,0,1,1,0,1,3,0,656,0,11,667,0
164,361,1,36,196,115,1,0,0,0,1,0,3,1,1,716,0,5,721,0
165,456,3,10,58,149,1,0,1,0,,1,1,2,3,687,0,16,703,0
166,258,5,13,516,7,0,2,3,3,1,3,6,1,1,819,0,11,830,0
167,444,3,9,78,101,4,0,0,0,1,0,2,4,1,647,0,12,659,0
168,234,2,71,491,75,1,1,0,0,1,1,1,5,0,883,0,12,895,0
169,204,5,17,735,6,1,3,0,5,2,0,3,2,0,983,0,3,986,0
170,125,2,4,521,8,0,1,0,3,0,1,2,1,1,669,0,2,671,0
171,182,1,4,395,3,0,0,0,0,0,0,0,2,1,588,0,7,595,0
172,300,2,35,7,162,1,1,0,0,0,1,0,0,1,510,0,7,517,0
173,276,1,4,106,52,0,0,1,0,1,0,4,1,2,448,0,7,455,0
174,514,0,16,8,46,1,1,0,0,0,1,1,0,1,589,0,12,601,0
175,287,1,18,171,37,0,1,0,1,0,0,0,0,0,516,0,4,520,0
176,279,1,16,73,91,4,2,1,0,1,1,1,2,2,474,0,6,480,0
177,38,1,3,435,4,0,4,1,1,1,2,3,4,1,498,0,6,504,0
178,200,0,3,360,8,1,4,0,0,0,0,2,1,0,579,0,5,584,0
179,41,0,8,431,17,1,1,0,0,0,1,0,0,0,500,0,1,501,0
180,73,1,7,482,8,1,1,3,1,0,2,3,0,1,583,0,0,583,0
181,286,2,33,582,76,3,2,1,1,9,2,4,8,1,1010,0,8,1018,0
182,428,3,92,97,184,5,1,0,0,2,1,0,2,1,816,0,6,822,0
183,275,3,59,83,137,5,5,2,0,1,2,2,3,0,577,0,6,583,0
184,457,6,136,11,43,1,3,1,0,1,2,2,3,3,669,0,11,680,0
185,128,1,60,163,104,2,3,4,0,1,1,0,1,3,471,0,2,473,0
186,259,3,30,65,132,5,0,1,0,0,1,0,2,0,498,0,12,510,0
187,198,3,17,606,11,0,5,1,2,1,1,3,4,4,856,0,3,859,0
188,502,3,48,11,49,1,0,0,3,1,0,2,0,2,622,0,9,631,0
189,58,0,1,475,4,1,2,1,0,2,1,5,2,0,552,0,4,556,0
190,158,2,39,461,104,2,5,0,3,0,0,6,7,2,789,0,6,795,0
191,196,5,17,230,26,3,2,0,0,1,0,2,0,2,484,0,4,488,0
192,361,4,3,105,26,0,1,2,0,3,2,0,0,1,508,0,4,512,0
193,396,3,66,13,101,0,0,0,0,0,1,1,2,0,583,0,2,585,0
194,453,0,39,13,124,0,0,0,3,0,0,0,0,0,632,0,9,641,0
195,112,5,14,756,28,4,5,4,4,3,1,10,7,0,953,0,18,971,0
196,247,1,8,563,2,0,1,1,0,1,0,2,2,1,829,0,4,833,0
197,277,6,68,326,152,9,2,2,0,0,3,1,2,3,851,0,7,858,0
198,178,5,16,393,10,0,1,7,0,2,2,3,1,1,619,0,4,623,0
199,854,6,109,22,75,1,1,1,1,0,0,3,1,0,1074,0,2,1076,0
200,349,5,205,28,50,4,4,3,2,4,5,7,8,5,679,0,19,698,0
201,406,1,20,10,252,6,1,0,0,0,0,0,0,0,696,0,1,697,0
202,651,4,38,14,171,8,1,0,12,0,2,0,0,0,901,0,0,901,0
203,277,3,6,20,320,4,1,5,1,0,2,1,2,5,647,0,11,658,0
204,226,4,7,114,201,4,2,2,0,1,1,0,0,2,564,0,               s,569,0
205,376,4,45,25,259,8,5,2,1,1,0,3,5,2,736,0,9,745,0
206,181,3,9,332,209,1,3,1,10,3,0,7,4,1,764,0,10,774,0
207,688,2,18,13,94,3,2,0,1,0,0,1,0,0,822,0,6,828,0
208,334,6,13,233,277,2,0,2,6,2,4,1,3,1,884,0,22,906,0
209,249,3,133,251,217,2,2,1,7,2,5,5,4,0,881,0,9,890,0
210,350,4,31,124,387,8,3,3,4,0,5,1,0,3,923,0,8,931,0
211,238,1,66,165,265,2,0,1,2,1,1,1,2,1,746,0,6,752,0
212,348,3,79,70,304,4,1,4,2,1,3,5,3,1,828,0,12,840,0
213,223,2,36,6,161,4,1,0,40,1,1,3,1,,479,0,11,490,0
214,214,12,12,85,231,3,0,4,18,1,0,0,2,1,583,0,2,585,0
215,470,5,78,17,178,4,3,2,30,0,3,4,2,1,797,0,21,818,0
216,236,2,12,237,40,2,2,1,35,0,2,4,2,,575,0,7,582,0
217,316,4,15,430,97,5,1,3,5,2,4,6,2,1,891,0,25,916,0
218,263,2,58,31,113,4,4,0,6,2,2,3,2,1,491,0,6,497,0
219,108,2,15,7,172,3,1,3,0,0,2,1,0,1,315,0,2,317,0
220,107,2,17,342,46,2,3,0,3,0,1,3,4,,530,0,10,540,0
221,211,3,11,16,175,3,1,0,0,1,0,2,1,1,425,0,6,431,0
222,95,4,105,14,242,4,0,2,1,4,1,0,0,1,473,0,2,475,0
223,305,0,53,16,364,2,2,2,1,0,0,0,1,1,747,0,1,748,0
224,321,4,33,6,317,4,3,4,3,0,3,2,4,0,704,0,7,711,0
225,0,0,0,0,0,0,0,0,0,0,0,0,0,0,0,0,0,0,0
226,0,0,0,0,0,0,0,0,0,0,0,0,0,0,0,0,0,0,0
227,0,0,0,0,0,0,0,0,0,0,0,0,0,0,0,0,0,0,0
228,0,0,0,0,0,0,0,0,0,0,0,0,0,0,0,0,0,0,0
229,0,0,0,0,0,0,0,0,0,0,0,0,0,0,0,0,0,0,0
230,0,0,0,0,0,0,0,0,0,0,0,0,0,0,0,0,0,0,0
1,373,2,81,295,81,0,1,1,0,2,0,6,1,0,843,0,11,854,0
2,158,1,18,671,136,5,2,3,0,3,4,13,4,4,1022,0,6,1028,0
3,80,0,4,442,9,1,0,1,0,2,0,10,4,0,553,0,1,554,0
4,546,2,15,373,75,1,4,0,2,0,1,1,2,2,1024,0,3,1027,0
5,229,0,93,386,150,4,0,1,0,2,0,4,3,3,875,0,4,879,0
6,88,0,3,513,27,1,0,2,0,0,0,3,3,0,640,0,0,640,0
7,175,4,11,326,307,4,3,3,0,2,6,2,3,2,848,0,5,853,0
8,74,1,5,551,87,3,3,0,1,1,0,3,1,2,732,0,7,739,0
9,19,1,6,624,22,0,0,0,1,3,1,6,9,1,693,0,6,699,0
10,270,3,81,225,418,8,2,0,2,0,5,1,5,0,1020,0,11,1031,0
11,29,2,1,226,157,0,1,0,0,3,3,2,2,2,429,0,2,431,0
12,209,2,19,227,161,2,1,0,1,1,2,5,4,1,636,0,5,641,0
13,425,4,89,73,372,4,1,0,2,0,0,1,1,3,976,0,12,988,0
14,221,8,10,84,257,1,0,0,0,1,1,0,0,0,584,0,0,584,0
15,372,3,57,6,370,0,1,0,0,3,1,0,0,0,814,0,12,826,0
16,519,4,18,75,379,5,3,0,0,0,0,2,1,0,1007,0,3,1010,0
17,257,4,29,384,146,2,2,3,0,0,2,0,2,2,833,0,6,839,0
18,303,2,17,17,266,6,0,1,0,1,1,2,1,2,619,0,10,629,0
19,174,1,8,102,241,2,0,0,0,   \    °,1,1,         ? 1,1,532,0,1,533,0
20,427,1,2,95,33,1,0,0,0,0,0,3,0,0,562,0,2,564,0
21,502,6,137,31,288,5,2,1,2,3,7,1,6,1,992,0,17,1009,0
22,890,1,34,47,23,0,1,0,0,0,0,0,0,1,997,0,3,1000,0
23,1114,3,4,8,27,0,1,0,0,0,1,0,0,0,1158,0,2,1160,0
24,249,4,26,135,112,2,2,1,1,2,2,3,2,1,542,0,9,551,0
25,197,2,12,10,172,2,1,1,1,3,3,1,1,0,406,0,9,415,0
26,335,3,39,84,151,9,4,2,1,1,5,3,3,4,644,0,10,654,0
27,342,1,27,15,348,9,1,4,3,1,3,0,2,3,759,0,9,768,0
28,176,0,25,5,117,4,0,1,0,0,1,0,0,0,329,0,4,333,0
29,326,1,25,360,15,1,1,4,1,5,1,4,6,1,751,0,3,754,0
30,287,3,88,122,146,1,2,1,2,0,4,3,2,1,662,0,5,667,0
31,337,4,150,232,126,3,4,4,0,3,3,7,6,4,883,0,11,894,0
32,393,5,71,18,147,1,1,1,0,0,2,2,2,3,646,0,14,660,0
33,596,1,47,78,104,2,3,1,0,3,1,1,3,0,840,0,10,850,0
34,428,2,103,39,166,1,1,0,1,0,1,0,3,0,745,0,9,754,0
35,367,5,24,120,283,12,5,2,2,4,3,7,3,3,840,0,11,851,0
36,76,3,2,415,5,0,4,0,1,3,0,5,4,0,518,0,4,522,0
37,385,3,30,34,317,7,0,2,0,1,2,1,1,1,784,0,9,793,0
38,414,1,28,17,94,0,1,1,0,2,1,1,1,0,561,0,7,568,0
39,336,1,52,6,390,5,4,4,0,1,4,2,3,0,808,0,11,819,0
40,358,5,174,21,166,2,2,1,0,1,5,2,4,0,741,0,12,753,0
41,381,4,101,50,183,6,3,5,0,4,1,3,6,3,750,0,17,767,0
42,317,2,29,180,112,2,2,3,1,1,1,1,2,1,654,0,1,655,0
43,354,7,114,115,215,2,2,8,0,2,4,2,3,0,828,0,8,836,0
44,456,3,32,6,109,2,0,0,1,2,0,0,1,1,613,0,15,628,0
45,570,2,11,58,145,0,2,0,0,0,1,0,0,0,789,0,2,791,0
46,423,2,14,320,173,2,2,0,0,1,2,1,1,0,941,0,1,942,0
47,384,9,86,71,169,2,1,0,1,1,1,1,0,2,728,0,4,732,0
48,271,3,4,255,114,3,1,1,3,4,3,1,5,2,670,0,11,681,0
49,387,8,102,185,241,2,3,1,0,       .       3,3,3,0,2,940,0,10,950,0
         SO,39,1,9,445,222,2,4,1,0,        \      1,5,5,4,2,740,0,4,744,0
51,207,2,3,507,116,2,12,12,3,2,2,6,4,4,882,0,18,900,0
52,390,4,8,230,99,3,1,10,1,1,1,5,2,2,757,0,14,771,0
53,94,2,22,795,15,1,4,1,0,4,0,8,4,0,950,0,5,955,0
54,245,2,20,619,18,0,1,1,0,3,1,4,3,1,918,0,3,921,0
55,261,2,16,166,228,2,3,0,2,1,0,5,2,2,690,0,3,693,0
56,153,2,6,581,12,0,6,0,1,2,1,2,1,2,769,0,4,773,0
57,86,1,9,507,208,2,4,1,0,2,1,2,3,1,827,0,4,831,0
58,369,6,13,157,140,2,3,1,0,3,0,1,2,3,700,0,6,706,0
59,333,3,12,89,435,6,2,2,0,1,0,3,1,4,891,0,13,904,0
60,197,6,14,249,292,8,7,4,1,4,6,4,5,1,798,0,2,800,0
61,405,3,27,26,321,8,1,0,0,1,5,2,2,1,802,0,13,815,0
62,162,2,6,385,161,6,1,5,4,2,1,2,1,3,741,0,3,744,0
63,203,3,22,442,57,4,4,0,1,7,6,7,1,5,762,0,14,776,0
64,132,2,5,415,15,1,0,0,0,2,0,4,1,1,578,0,4,582,0
65,937,1,4,5,145,2,0,1,0,0,2,0,0,0,1097,0,6,1103,0
66,378,4,2,11,162,4,0,1,1,1,0,0,0,0,564,0,8,572,0
67,387,1,5,101,127,2,1,0,0,0,1,1,0,0,626,0,3,629,0
68,206,1,5,520,69,2,1,1,1,3,2,8,4,2,825,0,9,834,0
69,248,1,16,281,114,1,4,2,0,2,2,3,0,1,675,0,8,683,0
70,300,5,15,78,385,6,2,2,3,1,3,3,2,0,805,0,13,818,0
71,92,1,3,81,151,2,1,0,0,2,2,0,1,0,336,0,4,340,0
72,268,4,2,297,288,5,4,2,0,1,5,5,3,3,887,0,8,895,0
73,281,2,4,190,94,1,2,0,1,1,2,4,0,0,582,0,6,588,0
74,247,1,114,54,363,2,1,3,0,1,11,8,3,1,809,0,13,822,0
75,408,3,5,40,385,2,6,3,0,2,6,4,2,1,867,0,14,881,0
76,168,3,15,657,207,6,3,2,3,3,4,10,5,4,1090,0,11,1101,0
77,267,3,20,216,346,1,3,1,1,3,1,2,0,1,865,0,6,871,0
78,191,0,11,248,35,0,1,0,0,2,1,1,2,0,492,0,6,498,0
79,509,1,17,23,328,3,2,1,2,0,0,2,4,0,892,0,11,903,0
80,90,2,7,636,32,2,3,1,0,5,2,1,5,2,788,0,6,794,0
81,251,2,190,49,132,1,2,2,1,       ?      0,0,10,3,1,644,0,14,658,0
82,310,3,22,75,209,2,3,2,2,2,1,4,3,2,640,0,24,664,0
83,218,5,78,76,326,7,2,4,1,0,3,2,4,1,727,0,6,733,0
84,236,2,26,139,169,1,3,1,0,2,1,2,1,1,584,0,3,587,0
85,210,1,0,3,170,1,0,0,1,0,0,0,0,0,386,0,1,387,0
86,342,4,24,54,292,2,2,0,0,1,0,1,1,2,725,0,6,731,0
87,390,1,30,59,58,1,0,0,0,0,2,0,0,2,543,0,11,554,0
88,170,2,38,334,160,2,1,1,0,2,1,0,1,3,715,0,3,718,0
89,340,3,33,53,310,5,3,1,2,1,2,2,4,1,760,0,14,774,0
90,294,3,10,15,449,5,2,2,0,0,1,3,1,1,786,0,3,789,0
91,208,0,11,474,123,1,0,2,0,1,0,4,1,0,825,0,9,834,0
92,298,1,34,453,133,2,2,0,0,0,3,5,1,1,933,0,13,946,0
93,387,1,5,181,262,7,3,2,0,3,4,5,3,4,867,0,12,879,0
94,274,1,28,11,194,0,3,1,1,0,1,2,1,0,517,0,8,525,0
95,326,5,8,243,278,4,1,3,3,1,1,4,3,1,881,0,11,892,0
96,47,2,6,804,8,0,3,0,0,0,1,4,1,2,878,0,0,878,0
97,100,0,6,607,16,1,2,1,0,2,0,1,1,0,737,0,2,          .   739,0
98,227,2,11,386,114,0,2,0,0,2,2,3,6,0,755,0,11,766,0
99,546,2,7,143,154,2,0,1,1,0,1,2,2,0,861,0,8,869,0
100,137,2,108,119,263,1,0,2,0,0,0,1,3,0,636,0,2,638,0
101,273,1,71,103,309,3,0,9,0,0,0,1,1,0,771,0,3,774,0
102,208,0,30,427,209,4,3,2,1,1,1,0,1,0,887,0,1,888,0
103,145,0,77,288,326,6,3,4,2,3,2,6,2,4,868,0,11,879,0
104,228,1,38,297,128,3,3,2,0,1,2,5,3,1,712,0,3,715,0
105,90,1,11,537,58,1,0,0,0,1,0,1,1,1,702,0,1,703,0
106,123,2,56,218,381,3,1,0,0,2,2,9,3,0,800,0,10,810,0
107,27,0,16,169,27,3,0,0,0,0,0,1,0,0,243,0,0,243,0
108,265,1,32,77,398,3,5,3,5,2,2,2,4,2,801,0,3,804,0
109,306,2,9,226,301,6,0,1,0,2,3,2,1,3,862,0,7,869,0
110,249,3,11,136,166,1,7,1,1,2,1,1,0,3,582,0,18,600,0
111,166,2,29,37,328,6,1,2,1,2,4,3,2,1,584,0,5,589,0
112,116,2,14,19,303,2,3,4,0,,2,1,1,0,469,0,5,474,0
113,208,1,66,46,177,4,2,0,0,1,3,0,6,4,518,0,16,534,0
114,155,2,41,129,252,2,0,5,0,2,3,0,0,2,593,0,5,598,0
115,332,1,21,165,199,1,4,1,0,2,0,0,0,2,728,0,7,735,0
116,524,8,13,72,262,4,1,2,0,3,1,2,1,2,895,0,11,906,0
117,202,2,47,314,243,2,5,5,3,2,4,2,0,1,832,0,7,839,0
118,127,2,13,405,325,3,2,2,2,2,3,4,0,0,890,0,3,893,0
119,49,0,3,431,25,1,1,1,0,1,0,4,1,0,517,0,2,519,0
120,147,1,24,138,285,2,1,1,1,2,3,1,0,0,606,0,8,614,0
121,86,0,6,640,5,1,1,,0,0,2,0,2,0,743,0,1,744,0
122,55,2,6,556,119,3,1,1,0,0,0,6,2,2,753,0,2,755,0
123,93,0,9,390,215,1,4,11,1,2,2,4,2,1,735,0,9,744,0
124,212,1,10,477,41,0,2,,0,0,0,3,4,0,750,0,5,755,0
125,94,3,18,506,280,12,8,1,0,0,4,4,3,1,934,0,5,939,0
126,199,3,342,150,110,1,1,7,0,1,2,3,4,2,825,0,1,826,0
127,92,3,16,314,127,3,0,1,0,2,4,5,0,2,569,0,7,576,0
128,88,2,56,61,265,5,1,1,2,1,2,0,1,2,487,0,6,493,0
129,218,1,43,41,219,0,1,2,1,2,1,1,1,1,532,0,4,536,0
130,359,6,38,180,208,2,4,5,2,4,6,1,5,1,821,0,11,832,0
131,125,0,23,195,169,4,1,9,2,2,1,1,0,0,532,0,4,536,0
132,333,4,68,35,363,7,0,1,0,0,1,2,1,3,818,0,6,824,0
133,227,0,11,5,177,4,1,0,0,0,0,1,1,0,427,0,6,433,0
134,492,1,10,26,140,4,0,0,0,0,1,2,2,2,680,0,10,690,0
135,369,3,139,117,173,6,3,41,3,1,5,3,4,3,870,0,19,889,0
136,496,2,98,14,257,1,2,1,0,2,1,2,1,,878,0,7,885,0
137,447,3,17,246,170,3,3,12,2,3,1,0,5,,913,0,16,929,0
138,97,1,61,32,402,1,1,5,1,2,3,3,3,,613,0,4,617,0
139,62,0,2,565,12,0,1,1,1,0,1,0,0,,645,0,2,647,0
140,32,1,3,460,6,1,0,0,1,0,0,2,1,,508,0,0,508,0
141,137,13,9,610,66,2,3,7,0,1,1,2,6,,858,0,6,864,0
142,242,1,14,95,314,2,2,3,0,3,0,1,2,,680,0,3,683,0
143,123,0,19,7,272,4,0,0,1,         f\    1,4,2,2,,436,0,6,442,0
144,424,1,6,23,187,4,1,1,1,2,1,2,2,1,656,0,17,673,0
145,348,3,9,100,305,6,2,4,2,1,5,4,4,1,794,0,21,815,0
146,235,4,19,17,382,9,2,1,0,2,2,2,1,1,677,0,9,686,0
147,286,1,4,9,119,5,0,0,0,0,2,0,1,1,428,0,13,441,0
148,393,2,17,75,418,8,0,1,1,3,8,5,3,3,937,0,32,969,0
149,183,2,17,392,294,13,1,7,0,2,8,5,6,1,931,0,11,942,0
150,69,2,3,761,47,0,1,0,1,2,0,8,4,1,899,0,0,899,0
151,312,0,11,247,299,4,1,1,0,3,1,3,5,3,890,0,10,900,0
152,85,3,14,654,26,1,2,2,1,2,1,4,1,0,796,0,4,800,0
153,157,0,9,227,186,1,5,0,2,0,2,5,3,2,599,0,10,609,0
154,68,9,2,566,77,1,1,0,0,0,0,3,1,1,729,0,2,731,0
155,34,3,5,515,65,1,2,1,1,2,0,3,3,0,635,0,4,639,0
156,17,10,6,444,16,0,0,0,0,1,0,2,1,0,497,0,1,498,0
157,44,2,169,219,118,5,4,1,2,2,1,7,0,0,574,0,4,578,0
158,32,5,5,503,14,0,0,0,0,3,1,2,0,1,566,0,0,566,0
159,205,3,0,158,188,6,5,4,1,2,1,6,0,4,583,0,11,594,0
160,360,2,22,113,366,2,1,2,0,0,1,1,3,1,874,0,1,875,0
161,48,1,3,374,6,0,0,1,0,0,0,2,1,0,436,0,2,438,0
162,284,4,96,38,251,4,3,1,1,2,3,1,0,2,690,0,8,698,0
163,291,3,58,58,267,4,1,0,1,1,1,2,2,2,691,0,5,696,0
164,128,2,3,21,123,0,0,3,0,1,2,0,0,0,283,0,5,288,0
165,143,1,10,664,23,0,0,5,0,1,0,6,0,1,854,0,6,860,0
166,297,3,20,107,219,2,0,2,0,1,1,1,0,1,654,0,2,656,0
167,298,0,7,324,110,0,2,3,0,2,1,2,0,0,749,0,3,752,0
168,154,2,4,744,16,0,2,3,0,0,0,4,4,1,934,0,2,936,0
169,437,3,50,77,309,4,4,2,1,1,0,0,1,0,889,0,3,892,0
170,218,0,19,219,251,2,2,3,1,1,1,0,2,2,721,0,4,725,0
171,171,1,2,138,77,1,0,1,0,0,1,0,0,0,392,0,2,394,0
172,273,2,7,28,258,4,0,4,1,0,1,2,0,2,582,0,7,589,0
173,438,1,31,18,338,5,4,2,0,0,0,3,0,1,841,0,7,848,0
174,485,5,41,169,230,0,2,4,0,          1     0,2,1,0,2,941,0,5,946,0
175,320,3,40,522,78,2,1,19,1,1,1,1,3,3,995,0,5,1000,0
176,148,0,21,452,44,1,7,3,1,4,3,3,1,4,692,0,8,700,0
177,150,1,73,199,260,7,2,3,1,2,3,7,4,3,715,0,6,721,0
178,360,0,5,195,117,1,1,0,0,0,0,1,1,0,681,0,2,683,0
179,399,6,5,99,164,2,3,25,0,3,0,5,1,2,714,0,16,730,0
180,463,2,5,88,112,1,2,2,0,3,0,0,5,0,683,0,12,695,0
181,384,3,6,60,250,2,0,7,1,0,0,0,3,2,718,0,1,719,0
182,353,1,2,43,142,3,0,0,0,3,1,1,1,4,554,0,5,559,0
183,174,2,4,85,156,2,3,0,2,0,0,2,1,2,433,0,2,435,0
184,547,0,10,11,263,0,2,0,0,0,1,0,0,0,834,0,1,835,0
185,233,2,25,3,144,0,0,0,0,1,2,2,1,0,413,0,5,418,0
186,238,3,10,162,230,6,1,2,1,4,3,5,1,4,670,0,16,686,0
187,415,2,25,296,68,1,0,1,1,3,1,2,1,4,820,0,21,841,0
188,333,5,7,50,63,0,0,0,2,3,0,0,4,0,467,0,14,481,0
189,69,1,7,289,35,1,1,0,1,2,1,1,1,2,411,0,2,413,0
190,310,3,4,296,212,5,3,1,0,0,4,7,4,2,851,0,3,854,0
191,283,1,10,581,18,1,1,0,1,0,0,6,8,1,911,0,7,918,0
192,265,3,5,533,50,3,2,1,2,0,1,5,2,1,873,0,11,884,0
193,327,0,5,192,139,1,2,0,0,2,0,1,1,0,670,0,7,677,0
194,494,2,11,14,302,3,3,1,0,1,3,3,2,3,842,0,16,858,0
195,316,3,9,386,150,7,1,11,1,0,3,3,2,1,893,0,13,906,0
196,305,1,23,328,90,2,5,3,1,0,1,1,2,1,763,0,8,771,0
197,222,1,9,299,114,0,2,2,1,2,2,5,0,0,659,0,6,665,0
198,111,4,1,309,12,0,2,1,2,3,0,1,3,2,451,0,9,460,0
199,68,1,92,214,24,1,6,173,3,1,1,0,2,0,586,0,3,589,0
200,79,3,29,373,10,1,1,6,0,0,2,0,2,0,506,0,0,506,0
201,345,2,249,125,203,5,5,26,2,3,1,4,9,6,985,0,15,1000,0
202,220,2,15,422,117,1,2,5,0,1,3,6,7,3,804,0,8,812,0
203,132,5,10,390,78,4,5,84,2,6,8,3,7,4,738,0,10,748,0
204,34,2,4,242,162,5,2,60,3,4,4,5,5,1,533,0,3,536,0
205,399,5,29,16,504,7,1,0,1,        f  ?     °,1,0,3,1,967,0,5,972,0
206,225,1,2,5,202,2,2,1,1,0,0,0,3,2,446,0,5,451,0
207,255,4,18,65,234,3,0,4,4,0,1,3,3,1,595,0,6,601,0
208,473,3,17,70,40,0,0,2,0,1,1,0,0,1,608,0,8,616,0
209,230,3,65,41,359,9,0,3,2,1,3,2,5,3,726,0,1,727,0
210,284,1,10,379,204,1,4,11,1,0,2,1,3,5,906,0,10,916,0
211,199,4,139,201,384,6,1,29,3,1,7,7,9,3,993,0,7,1000,0
212,330,0,77,68,317,3,3,5,2,1,3,3,1,1,814,0,4,818,0
213,50,1,19,790,18,0,9,2,0,2,3,2,5,1,902,0,4,906,0
214,548,5,44,26,294,1,4,0,7,3,3,8,8,3,954,0,12,966,0
215,292,2,50,151,296,4,1,2,2,1,0,0,0,0,801,0,0,801,0
216,200,4,54,463,203,1,0,1,0,0,0,1,0,0,927,0,1,928,0
217,53,1,10,587,61,1,4,2,0,2,5,1,4,0,731,0,4,735,0
218,415,2,45,172,266,4,5,1,1,2,1,2,3,1,920,0,9,929,0
219,357,2,96,7,196,2,0,0,0,0,1,0,0,1,662,0,2,664,0
220,181,0,24,192,106,1,3,4,0,4,0,2,1,2,520,0,8,528,0
221,131,2,20,541,166,3,3,3,2,8,3,11,3,0,896,0,4,900,0
222,308,5,169,25,336,4,4,1,0,1,4,2,4,1,864,0,14,878,0
223,404,4,164,228,216,5,5,3,1,1,0,5,2,4,1042,0,16,1058,0
224,0,0,0,0,0,0,0,0,0,0,0,0,0,0,0,0,0,0,0
225,0,0,0,0,0,0,0,0,0,0,0,0,0,0,0,0,0,0,0
226,0,0,0,0,0,0,0,0,0,0,0,0,0,0,0,0,0,0,0
227,0,0,0,0,0,0,0,0,0,0,0,0,0,0,0,0,0,0,0
228,0,0,0,0,0,0,0,0,0,0,0,0,0,0,0,0,0,0,0
229,0,0,0,0,0,0,0,0,0,0,0,0,0,0,0,0,0,0,0
230,0,0,0,0,0,0,0,0,0,0,0,0,0,0,0,0,0,0,0
1,303,3,16,640,36,0,3,3,0,2,1,7,3,2,1019,0,9,1028,0
2,71,0,5,638,15,0,2,1,2,0,0,5,2,2,743,0,0,743,0
3,225,4,23,180,370,10,1,3,3,2,7,3,2,4,837,0,2,839,0
4,332,3,9,360,64,0,0,1,0,2,1,0,1,1,774,0,5,779,0
5,140,0,6,509,31,0,1,0,0,2,0,1,3,0,693,0,2,695,0
6,72,0,3,661,60,0,0,1,0,0,0,3,1,0,801,0,1,802,0
7,504,2,15,135,70,0,1,0,0,0,0,1,2,0,730,0,4,734,0
8,250,1,8,275,161,1,0,5,0,1,0,1,0,0,703,0,2,705,0
9,700,6,30,78,293,1,0,3,0,0,1,1,0,0,1113,0,13,1126,0
10,329,2,67,263,244,3,3,7,1,6,6,4,3,2,940,0,15,955,0
11,437,5,51,399,124,2,2,1,1,4,2,7,1,1,1037,0,11,1048,0
12,250,5,33,221,93,1,1,1,0,0,0,5,5,0,615,0,4,619,0
13,263,1,51,46,87,2,0,0,1,2,3,1,3,1,461,0,9,470,0
14,543,2,93,275,162,6,4,0,1,2,2,11,7,5,1113,0,12,1125,0
15,490,1,20,30,232,3,1,2,0,1,9,1,4,0,794,0,16,810,0
16,323,0,19,33,88,1,0,0,0,0,2,0,1,1,468,0,13,481,0
17,50,0,14,539,4,0,1,3,0,1,4,21,7,2,646,0,3,649,0
18,154,1,3,318,80,0,0,0,0,0,4,9,0,3,572,0,8,580,0
19,190,1,9,88,268,0,0,2,0,1,18,5,1,1,584,0,13,597,0
20,69,2,12,656,32,1,0,0,0,0,4,17,2,3,798,0,4,802,0
21,75,1,8,512,18,0,0,0,0,1,1,16,0,2,635,0,6,641,0
22,203,2,12,136,187,2,0,1,0,0,4,3,0,2,552,0,15,567,0
23,429,2,12,387,222,2,1,1,1,1,2,5,2,3,1070,0,"             18
               7
               7
              8
             12
             13
               9
             12
             13
             10
               3
               4
             12
               3
             16
               8
               6
             10
               3
               5
             12
               4",1088,0
24,199,4,2,740,57,1,1,0,0,1,1,12,5,0,1023,0,,1030,0
25,160,0,30,316,338,4,1,1,0,1,5,9,5,1,871,0,,878,0
26,145,0,20,623,9,0,0,0,0,0,3,2,5,1,808,0,,816,0
27,233,1,16,770,84,0,2,0,0,0,0,16,4,0,1126,0,,1138,0
28,173,2,11,604,33,1,0,2,0,1,0,16,2,1,846,0,,859,0
29,183,0,24,209,57,0,0,0,0,0,1,4,1,0,479,0,,488,0
30,285,0,20,406,102,0,0,0,0,0,2,11,0,0,826,0,,838,0
31,187,1,11,417,218,2,1,1,0,3,4,18,3,2,868,0,,881,0
32,121,1,30,350,50,0,1,2,0,0,0,4,0,0,559,0,,569,0
33,65,1,12,413,31,0,1,0,0,0,2,4,2,1,532,0,,535,0
34,91,1,13,322,100,0,0,0,0,0,2,5,1,0,535,0,,539,0
35,146,0,9,817,32,0,0,0,1,2,5,39,2,1,1054,0,,1066,0
36,229,1,60,391,100,1,2,0,1,0,4,8,1,0,798,0,,801,0
37,355,6,14,366,84,1,2,1,1,1,2,14,5,3,855,0,,871,0
38,124,0,14,407,32,0,0,2,0,4,4,16,0,1,604,0,,612,0
39,316,1,23,69,174,1,1,0,1,0,1,0,2,1,590,0,,596,0
40,393,4,40,3,121,1,1,1,4,1,4,4,0,4,581,0,,591,0
41,373,4,11,451,102,7,5,2,0,1,3,3,3,0,965,0,,968,0
42,404,6,7,151,252,8,0,2,1,3,2,3,3,2,844,0,,849,0
43,458,5,17,263,249,4,3,2,0,0,2,4,5,4,1016,0,,1028,0
44,209,4,10,360,116,3,3,1,0,3,3,3,3,0,718,0,,722,0
45,135,2,69,694,24,2,4,3,2,1,5,11,6,3,961,0,9,970,0
46,317,2,44,117,147,2,3,0,1,1,2,1,7,6,650,0,15,665,0
47,177,3,18,90,165,2,1,0,1,0,0,2,2,3,464,0,2,466,0
48,420,0,21,14,514,1,2,4,1,1,3,1,2,0,984,0,7,991,0
49,282,3,41,136,149,0,5,0,2,4,1,6,1,3,633,0,6,639,0
50,154,1,10,283,9,0,1,1,1,3,1,2,3,0,469,0,2,471,0
51,437,4,158,8,185,1,0,0,1,0,0,0,0,0,794,0,0,794,0
52,182,1,155,61,152,1,1,2,0,0,0,1,0,0,556,0,1,557,0
53,559,2,14,5,113,1,1,0,1,0,1,0,0,0,697,0,4,701,0
54,542,3,29,209,163,3,1,1,0,1,0,2,0,0,954,0,3,957,0
55,443,4,39,347,112,0,2,0,1,1,0,3,8,1,961,0,12,973,0
56,364,4,2,317,203,2,0,1,1,1,3,3,3,1,905,0,13,918,0
57,469,2,46,224,255,5,3,0,1,2,0,6,1,1,1015,0,12,1027,0
58,231,2,5,666,22,1,4,5,1,4,2,8,8,2,961,0,11,972,0
59,139,2,5,812,25,1,2,1,3,2,3,7,2,1,1005,0,3,1008,0
60,62,3,2,571,44,2,6,3,2,1,3,6,9,1,715,0,6,721,0
61,268,5,39,356,129,4,7,131,2,1,2,2,4,0,950,0,8,958,0
62,260,3,7,524,77,1,1,26,2,3,0,5,5,4,918,0,10,928,0
63,529,0,123,17,561,5,2,4,0,0,2,5,0,2,1250,0,8,1258,0
64,323,0,25,260,373,5,1,4,1,3,2,4,1,2,1004,0,6,1010,0
65,536,1,20,11,547,5,1,4,0,2,7,1,3,1,1139,0,10,1149,0
66,239,0,0,266,4,0,1,0,0,0,0,4,2,0,516,0,4,520,0
67,284,2,78,115,182,2,3,0,4,0,1,1,1,1,674,0,3,677,0
68,510,3,137,32,460,1,2,3,1,0,1,3,1,1,1155,0,9,1164,0
69,207,2,77,352,132,2,4,8,1,2,1,6,7,2,803,0,6,809,0
70,325,2,50,165,453,11,4,1,0,2,3,5,1,5,1027,0,9,1036,0
71,227,4,76,77,415,8,5,3,0,0,2,1,3,3,824,0,19,843,0
72,559,1,44,98,349,4,4,3,2,0,1,5,3,2,1075,0,9,1084,0
73,391,2,44,14,171,1,0,0,0,1,1,0,2,0,627,0,1,628,0
74,211,3,215,6,109,1,2,0,0,1,1,0,0,0,549,0,6,555,0
75,277,2,65,476,63,1,2,1,2,5,6,2,3,1,906,0,7,913,0
76,361,2,200,127,265,0,1,4,0,3,4,3,4,2,976,0,16,992,0
77,61,1,66,906,49,1,6,0,4,4,0,5,4,0,1107,0,6,1113,0
78,35,1,4,572,31,0,1,1,1,0,2,3,3,1,655,0,1,656,0
79,157,0,25,318,117,0,1,2,0,0,1,3,0,3,627,0,1,628,0
80,98,0,5,408,29,2,1,3,0,0,1,2,1,1,551,0,0,551,0
81,107,2,24,510,20,0,3,1,2,4,0,6,3,1,683,0,8,691,0
82,198,1,31,268,43,1,2,7,0,1,0,1,0,0,553,0,3,556,0
83,125,1,2,503,6,1,4,1,0,1,2,7,1,1,655,0,2,657,0
84,79,3,4,442,13,1,2,0,0,1,1,3,3,0,552,0,4,556,0
85,146,1,5,698,6,1,1,3,1,0,0,5,4,2,873,0,4,877,0
86,155,0,36,169,236,5,0,1,8,1,0,1,1,1,614,0,4,618,0
87,78,3,97,238,172,3,0,0,1,2,2,2,2,1,601,0,3,604,0
88,451,6,321,22,247,7,3,2,2,0,2,2,2,3,1070,0,4,1074,0
89,82,3,7,584,10,1,0,0,1,5,1,4,5,2,705,0,1,706,0
90,29,1,5,547,13,2,1,0,0,3,0,3,3,1,608,0,8,616,0
91,390,5,224,19,149,1,0,2,0,0,0,0,2,2,794,0,3,797,0
92,173,1,1,77,177,2,0,0,1,1,1,1,0,0,435,0,4,439,0
93,290,1,19,20,310,1,0,1,0,1,1,0,1,1,646,0,8,654,0
94,602,5,17,28,338,1,1,1,0,3,2,0,0,1,999,0,7,1006,0
95,298,1,13,123,174,3,5,2,1,1,3,1,0,0,625,0,2,627,0
96,347,1,51,15,224,1,1,2,1,1,0,1,2,2,649,0,5,654,0
97,367,4,60,18,213,0,4,2,0,1,1,3,1,1,675,0,8,683,0
98,458,0,20,32,296,1,1,2,0,0,2,1,0,0,813,0,7,820,0
99,161,0,134,335,102,0,1,1,0,1,0,1,2,2,740,0,4,744,0
100,138,6,131,163,133,2,2,2,1,0,3,1,2,2,586,0,3,589,0
101,346,7,13,575,93,4,3,2,2,5,4,4,5,2,1065,0,11,1076,0
102,124,1,160,135,73,2,2,0,1,7,4,2,3,5,519,0,5,524,0
103,57,5,50,300,91,1,5,10,1,4,1,2,6,1,534,0,2,536,0
104,468,0,21,103,408,1,1,3,1,0,0,0,0,0,1006,0,1,1007,0
105,458,2,119,179,135,4,5,5,1,0,1,2,4,0,915,0,5,920,0
106,202,2,86,581,15,2,6,0,0,1,3,2,4,1,905,0,2,907,0
107,163,0,49,44,302,7,6,3,0,4,1,3,6,1,589,0,7,596,0
108,250,3,28,5,373,5,2,1,1,2,0,0,4,1,675,0,2,677,0
109,263,4,219,26,343,8,2,1,3,0,1,4,0,2,876,0,3,879,0
110,267,5,205,21,368,3,3,2,0,1,3,7,4,4,893,0,13,906,0
111,167,2,17,187,237,6,2,4,1,0,0,2,3,1,629,0,3,632,0
112,354,6,162,29,189,2,2,3,0,0,0,3,2,0,752,0,7,759,0
113,278,3,197,23,74,1,2,2,1,2,0,4,1,0,588,0,11,599,0
114,188,4,82,361,226,4,1,3,1,2,2,3,3,3,883,0,11,894,0
115,161,0,43,314,39,1,1,1,1,0,0,3,1,0,565,0,1,566,0
116,177,2,12,546,98,2,4,1,0,3,1,1,2,3,852,0,12,864,0
117,139,1,7,313,75,6,0,2,0,0,1,4,1,0,549,0,5,554,0
118,251,2,43,697,27,0,3,1,2,5,1,4,3,3,1042,0,3,1045,0
119,357,0,8,300,145,4,3,0,0,2,0,5,1,3,828,0,4,832,0
120,413,6,34,196,295,3,3,1,1,2,4,5,1,0,964,0,6,970,0
121,76,2,15,439,259,8,2,1,0,1,3,1,3,2,812,0,7,819,0
122,305,5,20,567,31,1,3,2,3,6,2,7,5,4,961,0,10,971,0
123,184,2,46,580,133,3,5,7,1,3,6,7,11,5,993,0,12,1005,0
124,284,1,36,668,42,1,4,2,0,3,3,1,3,2,1050,0,12,1062,0
125,178,1,49,7,242,6,0,1,0,1,1,0,2,1,489,0,5,494,0
126,107,1,43,93,209,5,4,1,1,0,4,2,0,0,470,0,8,478,0
127,59,4,82,532,20,1,2,0,5,2,1,2,4,1,715,0,2,717,0
128,22,0,307,87,95,2,7,0,2,1,0,1,3,3,530,0,3,533,0
129,42,2,74,849,28,0,4,0,1,4,2,5,3,2,1016,0,7,1023,0
130,414,6,211,139,94,1,0,2,0,0,3,4,4,2,880,0,12,892,0
131,44,0,25,612,13,0,5,0,0,0,2,2,2,1,706,0,0,706,0
132,191,5,31,438,42,4,4,4,4,4,3,4,8,3,745,0,8,753,0
133,456,7,208,87,237,1,9,3,1,3,0,0,0,1,1013,0,2,1015,0
134,511,4,189,68,132,0,0,0,1,1,0,1,1,0,908,0,0,908,0
135,168,6,63,50,312,8,4,5,2,1,1,4,5,6,635,0,7,642,0
136,257,9,323,55,195,2,5,3,2,3,4,5,2,0,865,0,3,868,0
137,688,6,47,36,87,2,3,0,1,0,0,6,2,3,881,0,19,900,0
138,531,2,24,25,215,5,1,2,0,1,0,0,2,0,808,0,1,809,0
139,258,3,6,413,104,0,1,2,0,2,0,4,7,2,802,0,8,810,0
140,753,3,29,30,82,4,1,1,0,1,0,2,2,3,911,0,4,915,0
141,609,4,42,71,246,4,4,4,2,1,3,2,1,0,993,0,19,1012,0
142,491,1,60,30,175,3,1,0,1,1,1,2,3,3,772,0,21,793,0
143,548,4,59,226,186,2,1,1,1,1,2,1,0,2,1034,0,5,1039,0
144,192,1,7,635,19,0,1,0,0,0,2,3,8,1,869,0,7,876,0
145,575,4,137,55,187,0,2,2,0,2,4,5,4,1,978,0,16,994,0
146,606,3,12,371,57,0,9,1,2,1,2,7,5,2,1078,0,6,1084,0
147,191,2,4,549,5,1,2,1,1,2,1,7,4,1,771,0,6,777,0
148,78,0,6,864,16,4,4,1,2,1,3,7,7,2,995,0,4,999,0
149,248,1,8,36,316,5,1,6,0,0,3,2,2,1,629,0,8,637,0
150,103,0,2,304,79,2,1,2,0,1,0,3,4,0,501,0,6,507,0
151,182,4,5,797,16,0,6,1,1,4,7,5,6,0,1034,0,10,1044,0
152,104,0,14,737,125,2,5,4,1,5,3,7,3,2,1012,0,5,1017,0
153,341,1,29,70,330,3,3,2,1,1,0,1,2,1,785,0,13,798,0
154,277,6,41,25,285,4,3,0,0,0,2,2,1,0,646,0,4,650,0
155,106,1,13,319,93,0,10,2,0,1,0,4,2,0,551,0,1,552,0
156,291,3,100,259,448,10,2,0,1,2,5,4,5,3,1133,0,7,1140,0
157,342,1,45,259,341,1,1,2,1,3,2,5,4,0,1007,0,2,1009,0
158,498,8,140,171,220,4,0,5,1,2,2,0,6,2,1059,0,9,1068,0
159,222,2,45,252,134,1,0,2,3,0,1,2,3,0,667,0,1,668,0
160,192,2,8,763,14,0,7,4,1,2,2,11,9,4,1019,0,6,1025,0
161,120,0,16,597,13,0,4,0,0,2,1,10,3,4,770,0,7,777,0
162,59,4,8,786,23,1,3,0,0,1,0,0,1,0,886,0,1,887,0
163,124,4,9,596,54,1,2,0,3,5,1,6,3,1,809,0,4,813,0
164,102,1,6,606,23,0,2,2,0,2,1,3,5,2,755,0,3,758,0
165,93,2,27,873,63,3,5,5,5,2,4,11,6,0,1099,0,10,1109,0
166,434,0,25,364,91,1,5,1,0,3,1,10,2,2,939,0,16,955,0
167,113,1,38,542,27,2,0,1,0,0,1,6,3,0,734,0,8,742,0
168,133,0,7,335,11,0,2,0,1,1,1,4,2,2,499,0,6,505,0
169,237,5,8,322,57,7,3,0,1,3,1,2,5,1,652,0,7,659,0
170,304,1,8,771,18,1,2,3,0,1,4,6,4,0,1123,0,3,1126,0
171,351,0,61,409,155,2,2,0,1,2,2,4,8,1,998,0,11,1009,0
172,361,5,53,342,99,4,3,1,1,2,3,4,4,2,884,0,10,894,0
173,401,3,16,469,35,2,3,0,2,4,3,3,4,0,945,0,13,958,0
174,181,1,25,559,121,1,1,1,0,0,4,4,3,0,901,0,8,909,0
175,211,3,7,631,72,5,2,6,3,2,5,27,8,5,987,0,18,1005,0
176,399,0,5,595,21,1,2,1,1,1,6,9,5,0,1046,0,13,1059,0
177,208,2,10,486,31,1,4,2,6,1,3,7,3,4,768,0,10,778,0
178,149,2,22,711,23,3,10,3,2,3,3,7,5,1,944,0,4,948,0
179,238,1,113,149,187,5,0,4,1,0,4,3,2,2,709,0,11,720,0
180,306,1,12,472,46,0,3,4,5,1,3,3,2,2,860,0,5,865,0
181,261,2,10,696,147,1,1,1,5,3,5,7,4,1,1144,0,9,1153,0
182,218,0,13,729,29,0,1,1,0,2,1,7,3,1,1005,0,2,1007,0
183,319,1,19,419,73,0,6,2,13,2,3,2,6,2,867,0,6,873,0
184,318,1,10,193,32,0,1,0,1,0,1,3,2,0,562,0,10,572,0
185,441,2,24,13,42,1,1,1,1,0,0,2,1,2,531,0,7,538,0
186,177,1,13,614,31,1,4,6,0,2,1,2,3,0,855,0,5,860,0
187,87,0,14,552,13,0,0,0,0,2,1,3,0,1,673,0,0,673,0
188,365,6,15,695,53,0,3,0,3,7,0,12,11,6,1176,0,8,1184,0
189,130,2,19,791,10,0,1,2,2,4,0,8,7,0,976,0,12,988,0
190,511,1,7,11,197,4,0,1,1,0,1,1,0,0,735,0,8,743,0
191,211,2,3,555,8,0,1,0,1,1,0,1,4,1,788,0,7,795,0
192,72,0,11,908,9,2,7,1,1,6,7,19,7,3,1053,0,9,1062,0
193,290,3,9,354,48,0,1,0,0,0,0,3,2,0,710,0,2,712,0
194,255,0,41,512,139,1,3,0,3,3,2,6,4,0,969,0,3,972,0
195,246,0,115,9,116,0,2,0,0,0,1,2,1,1,493,0,5,498,0
196,255,4,83,125,115,1,0,1,2,2,1,3,1,1,594,0,4,598,0
197,404,0,66,400,159,1,1,0,0,3,2,2,3,1,1042,0,6,1048,0
198,655,1,37,65,60,3,0,0,2,1,0,3,1,2,830,0,19,849,0
199,422,4,247,141,102,0,3,3,0,0,1,2,3,3,931,0,8,939,0
200,166,1,23,712,14,3,5,2,6,5,3,11,2,1,954,0,5,959,0
201,75,3,21,926,9,3,2,1,0,2,2,10,7,4,1065,0,9,1074,0
202,72,0,13,828,9,1,2,1,1,4,2,17,9,2,961,0,1,962,0
203,308,1,13,490,10,1,1,0,0,1,1,3,3,0,832,0,6,838,0
204,137,2,9,762,18,1,3,1,1,8,0,8,10,1,961,0,9,970,0
205,551,7,52,120,84,9,9,0,0,1,3,8,1,3,848,0,17,865,0
206,245,3,43,78,94,3,24,2,0,3,2,1,3,3,504,0,4,508,0
207,422,2,24,289,33,5,3,0,2,0,0,3,1,1,785,0,7,792,0
208,167,1,7,522,24,0,11,2,0,2,2,8,3,0,749,0,5,754,0
209,410,3,25,333,97,4,1,0,2,2,1,4,6,3,891,0,14,905,0
210,488,4,24,299,106,4,6,2,1,2,3,3,2,1,945,0,8,953,0
211,262,2,47,544,244,4,5,5,1,7,4,2,3,1,1131,0,11,1142,0
212,539,4,184,89,206,2,3,0,0,1,1,1,1,0,1031,0,11,1042,0
213,368,10,206,11,110,0,0,1,0,1,0,3,3,6,719,0,14,733,0
214,434,2,44,25,152,2,1,0,0,1,1,1,1,0,664,0,10,674,0
215,634,2,74,24,259,5,1,4,1,1,2,0,4,2,1013,0,6,1019,0
216,561,5,149,23,147,2,4,3,3,1,0,3,4,2,907,0,8,915,0
217,815,4,140,23,113,0,2,4,1,0,1,2,4,1,1110,0,21,1131,0
218,481,2,39,13,99,2,3,3,0,0,3,0,1,0,646,0,12,658,0
219,426,2,21,8,51,1,0,1,0,0,1,1,0,0,512,0,8,520,0
220,720,4,56,8,210,2,3,1,2,1,1,1,0,1,1010,0,4,1014,0
221,255,4,25,338,82,1,3,0,5,1,3,2,2,2,723,0,7,730,1
222,95,3,9,709,7,1,3,3,0,3,4,6,3,0,846,0,5,851,0
223,64,0,18,562,15,0,2,1,1,3,1,2,3,1,673,0,4,677,0
224,57,2,10,535,25,0,0,1,1,4,0,3,1,1,640,0,1,641,0
225,62,1,4,643,8,1,2,0,1,4,0,5,4,1,736,0,6,742,0
226,34,0,4,547,30,2,8,1,0,0,0,7,0,2,635,0,3,638,0
227,51,2,8,496,11,0,1,1,0,1,0,12,2,1,586,0,1,587,0
228,69,2,22,787,26,1,8,1,1,3,3,7,2,1,933,0,2,935,0
229,81,0,7,680,6,1,3,0,0,0,1,4,4,0,787,0,4,791,0
230,451,1,131,282,246,2,8,1,1,3,4,4,6,3,1143,0,9,1152,0
231,190,3,57,386,110,3,4,0,0,1,4,7,2,0,767,0,6,773,0
232,65,2,11,400,21,1,5,0,1,5,1,3,3,0,518,0,6,524,0
233,143,2,22,776,35,0,2,1,0,2,2,15,8,0,1008,0,8,1016,0
234,348,3,66,8,211,3,2,1,0,0,0,2,4,1,649,0,4,653,0
235,153,0,34,263,87,2,1,0,1,2,1,1,0,0,545,0,3,548,0
236,94,1,12,358,103,1,2,1,4,1,3,6,4,1,591,0,6,597,0
237,67,1,9,520,36,2,3,1,1,2,6,12,10,2,672,0,7,679,0
238,268,3,51,683,46,2,4,2,2,3,2,6,6,2,1080,0,12,1092,0
239,328,4,196,118,28,2,1,1,1,2,2,4,5,3,695,0,18,713,0
240,260,0,30,111,26,1,0,0,0,1,0,0,1,0,430,0,3,433,0
241,422,9,389,123,110,3,6,2,5,4,1,4,8,5,1091,0,22,1113,0
242,272,6,391,238,75,3,8,25,1,2,4,2,6,5,1038,0,19,1057,0
243,270,7,518,127,70,3,1,1,2,1,4,3,2,1,1010,0,7,1017,0
1,496,7,365,53,32,0,1,0,1,0,0,4,4,4,967,0,12,979,0
2,259,6,235,395,38,0,1,1,1,0,2,9,5,2,954,0,13,967,0
3,558,3,45,81,192,2,6,5,2,1,5,1,2,1,904,0,13,917,0
4,233,6,216,126,292,7,4,2,1,1,8,11,3,1,911,0,12,923,0
5,344,1,53,255,202,2,1,0,0,1,1,1,2,1,864,0,6,870,0
6,83,3,11,547,104,1,2,2,2,0,1,3,4,2,765,0,5,770,0
7,33,0,6,447,142,2,3,1,0,1,2,5,1,0,643,0,1,644,0
8,330,2,84,82,271,2,1,4,0,0,3,3,3,1,786,0,6,792,0
9,508,1,99,5,44,1,1,0,0,0,0,1,0,1,661,0,14,675,0
10,456,7,212,255,34,1,6,2,2,4,2,2,5,6,994,0,12,1006,0
11,576,                         ?          5,235,173,109,0,2,8,2,2,1,1,1,0,1115,0,3,1118,0
12,453,4,150,53,302,4,2,0,0,1,2,1,3,0,975,0,4,979,0
13,542,2,124,44,81,4,5,2,0,1,3,2,3,4,817,0,27,844,0
14,201,6,57,413,164,4,1,1,0,3,2,2,6,1,861,0,7,868,0
15,114,0,54,252,303,5,2,1,0,0,3,4,1,1,740,0,3,743,0
16,346,2,69,453,25,1,1,3,1,3,1,6,3,2,916,0,9,925,0
17,296,2,18,452,10,0,3,0,0,3,0,7,3,3,797,0,9,806,0
18,282,1,169,105,73,0,2,0,1,0,1,0,4,2,640,0,3,643,0
19,419,1,183,95,101,1,3,1,1,1,2,2,3,3,816,0,16,832,0
20,371,3,37,485,152,2,2,3,2,3,5,9,5,1,1080,0,18,1098,0
21,297,0,7,665,16,0,6,0,2,5,6,6,4,1,1015,0,10,1025,0
22,202,0,11,578,34,1,0,1,0,3,5,8,10,1,854,0,11,865,0
23,288,5,12,552,7,0,2,1,2,1,2,11,5,2,890,0,25,915,0
24,420,9,98,236,8,1,3,1,0,0,1,1,7,1,786,0,14,800,0
25,131,5,11,867,23,1,7,3,2,3,6,14,14,5,1092,0,11,1103,0
26,446,3,141,237,92,1,3,2,0,0,0,4,6,1,936,0,12,948,0
27,184,4,306,11,108,5,3,1,0,1,0,3,1,0,627,0,14,641,0
28,483,1,246,11,102,1,2,0,0,1,0,4,0,0,851,0,8,859,0
29,653,3,90,5,69,3,2,1,0,1,1,3,2,2,835,0,15,850,1
30,287,5,240,195,100,0,3,2,1,0,1,12,7,2,855,0,7,862,0
31,136,5,140,389,16,0,2,1,0,3,1,6,2,0,701,0,8,709,0
32,189,4,217,253,71,1,5,0,0,2,0,9,8,1,760,0,6,766,0
33,571,3,227,86,100,3,8,1,1,7,5,2,8,3,1025,0,13,1038,0
34,500,1,25,191,360,4,2,7,0,5,4,5,4,0,1108,0,12,1120,0
35,380,2,15,390,34,0,2,1,4,1,3,2,4,2,840,0,19,859,0
36,43,1,39,758,39,2,4,0,2,5,3,10,5,0,911,0,8,919,0
37,332,5,115,419,66,1,1,3,0,1,3,8,3,2,959,0,16,975,0
38,393,2,11,645,36,0,5,0,0,1,1,8,3,3,1108,0,14,1122,0
39,296,5,55,618,108,0,5,4,2,1,5,9,12,5,1125,0,11,1136,0
40,215,1,44,319,288,4,2,1,1,2,3,5,1,3,889,0,4,893,0
41,220,1,35,316,13,0,1,0,0,0,3,8,6,1,604,0,10,614,0
42,481,3,188,107,274,4,3,1,2,1,3,9,9,1,1086,0,19,1105,0
43,96,3,37,431,53,1,1,1,1,2,9,12,9,3,659,0,12,671,0
44,194,1,52,748,36,1,3,0,0,1,2,13,8,3,1062,0,14,1076,0
45,210,5,34,866,25,3,1,2,1,1,2,7,10,3,1170,0,9,1179,0
46,311,1,36,273,131,2,1,2,0,2,2,2,1,2,766,0,18,784,0
47,160,5,20,681,84,2,4,3,2,8,2,5,7,1,984,0,12,996,0
48,199,0,58,559,65,2,3,1,0,2,2,2,1,3,897,0,10,907,0
49,183,2,40,526,48,2,4,9,1,3,6,7,3,1,835,0,4,839,0
50,138,4,56,523,22,1,0,17,3,3,1,4,4,2,778,0,6,784,0
51,489,3,21,562,35,2,4,1,1,2,0,6,6,1,1133,0,10,1143,0
52,329,0,66,274,23,0,3,2,0,1,1,6,2,2,709,0,6,715,0
53,506,7,157,107,99,2,2,1,0,2,1,7,5,3,899,0,20,919,0
54,204,3,11,534,18,0,1,1,1,0,1,13,3,2,792,0,5,797,0
55,415,3,166,304,71,1,6,1,3,2,3,6,10,2,993,0,10,1003,0
56,155,3,25,665,11,3,5,2,1,5,3,10,3,0,891,0,4,895,0
57,122,3,92,815,19,0,4,3,2,0,3,11,10,1,1085,0,6,1091,0
58,124,5,40,403,25,0,3,2,0,2,2,5,2,0,613,0,2,615,0
59,61,1,32,687,12,0,8,0,3,4,1,6,2,1,818,0,2,820,0
60,226,3,261,436,87,2,3,3,1,1,1,2,11,1,1038,0,3,1041,0
61,365,2,246,107,160,6,3,3,1,1,4,7,4,4,913,0,17,930,0
62,291,4,69,446,19,3,3,0,0,2,4,9,4,2,856,0,8,864,0
63,635,5,27,240,86,3,4,2,0,0,1,4,3,2,1012,0,16,1028,0
64,67,1,16,603,22,1,0,2,0,1,2,1,4,0,720,0,9,729,0
65,48,1,8,499,15,2,1,1,0,1,0,5,0,1,582,0,8,590,0
66,561,2,82,37,99,2,0,0,1,0,0,1,0,2,787,0,16,803,0
67,294,3,82,125,42,1,0,3,0,1,1,2,3,0,557,0,9,566,0
68,165,3,126,97,166,1,0,1,0,1,0,3,5,2,570,0,6,576,0
69,265,5,226,29,104,1,2,1,2,2,1,3,2,2,645,0,4,649,0
70,633,3,113,14,108,3,0,0,1,0,1,1,9,6,892,0,32,924,0
71,89,2,27,862,11,2,6,2,0,2,2,13,4,2,1024,0,5,1029,0
72,351,3,66,194,70,2,0,0,1,3,0,1,0,0,691,0,3,694,0
73,209,3,235,34,56,3,4,1,1,1,2,4,2,2,557,0,10,567,0
74,510,2,29,3,9,0,1,2,0,0,1,0,0,0,557,0,10,567,0
75,473,3,113,23,241,6,4,1,3,0,0,2,1,3,873,0,8,881,0
76,475,7,222,153,56,1,2,2,2,1,5,5,6,2,939,0,11,950,0
77,258,4,109,533,70,2,4,0,1,5,3,9,6,7,1011,0,20,1031,0
78,160,4,17,762,13,2,2,0,0,2,8,15,9,4,998,0,10,1008,0
79,191,4,37,513,39,0,2,1,2,0,0,7,2,0,798,0,7,805,0
80,381,0,141,15,192,2,0,1,0,0,2,6,3,6,749,0,16,765,0
81,85,1,36,974,24,0,5,1,2,3,5,17,10,1,1164,0,4,1168,0
82,74,1,14,523,19,1,1,0,2,2,1,3,4,2,647,0,1,648,0
83,84,1,8,465,44,1,0,1,0,3,2,3,3,2,617,0,5,622,0
84,183,4,19,592,44,0,6,2,1,2,4,7,7,2,873,0,14,887,0
85,157,3,91,484,14,1,5,0,0,3,2,3,4,2,769,0,11,780,0
86,202,3,82,661,53,0,1,0,1,2,1,6,5,1,1018,0,15,1033,0
87,300,1,17,664,54,0,3,0,3,6,2,10,8,1,1069,0,16,1085,0
88,90,4,44,705,70,3,4,1,12,2,3,3,5,3,949,0,4,953,0
89,134,2,65,680,45,0,4,3,2,2,5,9,7,2,960,0,7,967,0
90,283,1,23,749,54,0,2,0,0,3,2,5,4,2,1128,0,7,1135,0
91,152,1,22,650,51,2,0,2,1,1,3,5,3,2,895,0,4,899,0
92,151,1,2,208,4,0,1,2,0,0,0,0,1,0,370,0,1,371,0
93,295,8,21,346,155,3,1,0,1,0,2,7,4,0,843,0,4,847,0
94,312,0,45,9,83,0,0,0,0,0,0,0,1,0,450,0,6,456,0
95,163,1,33,556,15,1,2,3,0,1,3,8,5,1,792,0,9,801,0
96,219,2,7,406,7,0,1,1,0,1,1,5,6,2,658,0,9,667,0
97,102,1,81,560,54,1,3,0,1,0,2,6,8,3,822,0,8,830,0
98,91,2,18,365,11,1,2,0,1,1,0,6,5,0,503,0,6,509,0
99,117,3,43,680,37,2,3,3,0,3,1,18,3,2,915,0,10,925,0
100,163,1,65,787,16,0,5,2,1,3,4,17,6,1,1071,0,8,1079,0
101,372,4,175,215,99,2,6,0,2,2,2,2,3,3,887,0,10,897,0
102,312,5,45,201,162,3,1,0,1,0,1,3,0,1,735,0,4,739,0
103,258,2,21,641,2,0,2,0,1,1,3,3,5,0,939,0,9,948,0
104,290,3,21,546,20,0,1,2,0,2,3,6,4,2,900,0,9,909,0
105,500,2,42,342,50,1,3,2,1,2,1,2,1,1,950,0,16,966,0
106,111,2,26,687,27,1,5,0,0,2,3,6,5,4,879,0,4,883,0
107,555,3,93,59,69,0,0,0,1,0,2,2,4,2,790,0,28,818,0
108,521,4,144,44,125,1,0,1,0,0,1,2,5,1,849,0,16,865,0
109,447,0,18,65,163,2,0,0,0,2,3,1,3,2,706,0,10,716,0
110,179,1,11,368,8,0,1,2,0,0,1,2,9,2,584,0,2,586,0
111,231,2,1,368,33,3,4,1,0,1,1,1,4,1,651,0,10,661,0
112,617,1,210,26,220,7,0,1,1,0,3,6,11,2,1105,0,15,1120,0
113,616,4,91,165,23,0,4,0,0,2,0,9,8,5,927,0,22,949,0
114,386,3,151,77,30,2,0,1,0,0,1,1,1,2,655,0,8,663,0
115,342,2,87,73,71,0,1,0,0,0,0,3,4,0,583,0,10,593,0
116,372,5,114,372,86,0,3,1,1,3,7,9,34,7,1014,0,12,1026,0
117,396,1,16,492,57,1,4,1,1,5,1,12,13,2,1002,0,12,1014,0
118,93,0,13,630,196,1,2,1,0,3,2,7,2,3,953,0,3,956,0
119,199,1,12,821,32,0,6,1,1,9,0,12,9,0,1103,0,10,1113,0
120,475,2,30,345,36,1,3,0,1,1,1,5,11,1,912,0,12,924,0
121,609,6,13,493,35,2,1,1,2,2,2,5,4,0,1175,0,22,1197,0
122,326,8,29,647,24,0,3,2,1,3,4,4,5,4,1060,0,6,1066,0
123,267,3,46,384,27,0,0,1,0,0,0,6,1,0,735,0,9,744,0
124,68,4,53,470,14,0,5,4,2,1,0,2,1,1,625,0,2,627,0
125,133,1,7,437,13,0,5,0,0,0,1,0,4,2,603,0,3,606,0
126,425,5,74,524,120,1,2,1,0,0,0,1,0,0,1153,0,3,1156,0
127,194,4,33,702,28,3,5,2,1,3,4,5,6,4,994,0,5,999,0
128,407,6,11,416,45,0,3,1,0,3,1,8,3,1,905,0,10,915,0
129,233,1,35,638,30,0,1,2,0,2,2,5,6,1,956,0,9,965,0
130,151,2,20,630,52,1,5,1,2,2,2,8,6,4,886,0,6,892,0
131,206,1,28,682,39,3,1,2,15,2,2,4,3,1,989,0,9,998,0
132,108,1,7,128,34,2,4,1,0,0,0,1,0,0,286,0,1,287,0
133,280,2,18,497,5,0,1,1,24,1,0,4,0,2,835,0,9,844,0
134,367,0,25,577,30,1,3,0,9,0,3,8,2,2,1027,0,11,1038,0
135,517,2,78,209,89,0,0,0,0,0,0,7,1,0,903,0,5,908,0
136,605,30,37,230,104,3,0,1,0,2,1,2,2,0,1017,0,14,1031,0
137,488,3,62,315,83,0,0,6,2,1,2,4,2,1,969,0,10,979,0
138,352,2,20,154,52,1,1,1,0,1,0,1,0,1,586,0,6,592,0
139,132,0,15,442,24,1,1,14,6,2,1,4,1,2,645,0,2,647,0
140,315,3,16,395,161,1,1,1,0,2,2,2,2,1,902,0,4,906,0
141,717,3,79,43,102,1,1,0,0,2,1,1,6,1,957,0,16,973,0
142,227,1,33,592,20,1,3,1,1,3,2,5,4,0,893,0,7,900,0
143,420,0,50,287,72,2,3,0,0,1,3,6,9,2,855,0,8,863,0
144,193,1,43,669,44,0,4,0,0,1,1,10,4,3,973,0,5,978,0
145,327,2,97,530,42,5,2,1,0,1,5,8,13,7,1040,0,14,1054,0
146,166,3,101,377,20,1,1,6,25,1,2,4,1,3,711,0,7,718,0
147,263,2,73,458,72,1,2,1,8,2,0,3,3,4,892,0,5,897,0
148,327,3,54,402,33,0,2,1,3,0,0,5,1,1,832,0,3,835,0
149,210,2,61,277,26,0,1,0,1,0,1,3,3,1,586,0,5,591,0
150,488,4,58,394,47,3,4,0,0,2,1,7,5,3,1016,0,8,1024,0
151,347,0,177,57,67,1,2,0,1,0,0,1,1,1,655,0,7,662,0
152,218,0,55,167,85,0,0,0,0,0,1,1,0,0,527,0,2,529,0
153,258,3,20,785,13,0,5,0,2,3,4,12,4,0,1109,0,14,1123,0
154,310,1,33,431,21,0,2,4,1,0,3,8,5,1,820,0,10,830,0
155,619,2,100,50,117,0,1,1,0,1,0,2,3,0,896,0,5,901,0
156,459,5,28,276,324,0,0,0,0,0,1,4,1,1,1099,0,3,1102,0
157,431,4,175,204,112,3,2,3,1,0,0,4,7,2,948,0,8,956,0
158,143,1,11,403,15,1,2,2,1,0,1,8,4,3,595,0,6,601,0
159,341,2,136,75,42,2,2,2,0,0,8,1,2,0,613,0,7,620,0
160,429,3,42,427,72,1,4,2,1,1,6,5,2,0,995,0,4,999,0
161,514,2,176,337,24,2,0,1,0,0,2,9,1,0,1068,0,12,1080,0
162,204,1,28,333,19,0,1,1,0,1,1,4,1,0,594,0,3,597,0
163,387,1,51,318,21,0,3,1,2,0,8,13,6,0,811,0,16,827,0
164,359,3,41,443,28,1,2,0,1,4,4,6,1,4,897,0,11,908,0
165,370,5,78,343,47,1,1,1,0,2,1,6,1,2,858,0,5,863,0
166,188,1,28,158,6,2,0,0,0,0,0,1,0,0,384,0,1,385,0
167,619,6,144,191,34,1,0,2,0,1,0,3,0,0,1001,0,2,1003,0
168,572,9,305,114,80,2,4,1,0,1,0,5,7,3,1103,0,10,1113,0
169,608,4,92,75,112,1,0,1,0,0,1,4,4,0,902,0,5,907,0
170,452,2,22,479,136,1,4,0,2,3,3,6,1,6,1117,0,11,1128,0
171,370,0,18,14,61,0,0,0,0,0,1,0,0,0,464,0,7,471,0
172,318,3,45,199,128,3,2,0,1,4,1,2,5,4,715,0,6,721,0
173,453,3,100,485,60,3,5,3,0,5,4,3,4,5,1133,0,14,1147,0
174,337,5,27,645,20,3,4,0,0,1,1,13,5,2,1063,0,18,1081,0
175,407,5,130,383,90,2,4,2,1,3,4,11,5,1,1048,0,24,1072,0
176,161,5,95,611,10,0,4,0,4,3,3,4,9,0,909,0,8,917,0
177,266,5,40,532,166,2,5,1,1,7,5,14,11,2,1057,0,11,1068,0
178,181,3,21,567,56,0,5,4,1,2,2,10,5,3,860,0,4,864,0
179,167,5,16,563,32,2,4,3,1,3,3,7,10,0,816,0,8,824,0
180,658,1,165,82,204,0,0,2,1,0,1,4,3,1,1122,0,5,1127,0
181,277,8,49,531,51,2,2,2,0,2,6,19,10,4,963,0,8,971,0
182,552,2,95,278,160,1,1,5,0,2,5,10,3,2,1116,0,13,1129,0
183,392,0,29,5,61,0,0,0,0,0,0,0,0,1,488,0,0,488,0
184,432,5,141,23,79,0,0,0,0,1,0,0,1,0,682,0,3,685,0
185,381,5,118,176,83,2,1,0,1,1,2,3,3,5,781,0,17,798,0
186,285,4,91,495,47,1,4,0,1,2,1,6,7,1,945,0,4,949,0
187,322,8,88,539,43,5,7,1,2,4,2,9,13,3,1046,0,7,1053,0
188,571,2,50,92,179,0,2,0,2,1,2,4,5,5,915,0,16,931,0
189,401,1,71,462,40,3,7,7,0,2,4,5,8,1,1012,0,9,1021,0
190,607,0,89,347,35,0,2,1,0,2,6,12,7,1,1109,0,21,1130,0
191,511,2,66,397,117,3,5,0,1,2,2,3,6,1,1116,0,11,1127,0
192,155,0,35,361,47,1,0,0,1,1,0,1,1,1,604,0,9,613,0
193,127,0,19,729,9,1,3,0,4,2,5,4,9,3,915,0,2,917,0
194,694,2,121,18,304,1,1,0,0,1,0,1,1,1,1145,0,10,1155,0
195,498,3,55,45,216,2,0,0,0,2,3,2,0,0,826,0,14,840,0
196,113,0,48,700,41,2,3,1,1,4,1,6,7,0,927,0,5,932,0
197,199,0,29,556,38,0,0,1,0,0,1,4,3,1,832,0,9,841,0
198,402,1,84,160,100,0,1,0,0,0,2,1,1,2,754,0,9,763,0
199,602,3,133,178,145,0,0,1,2,0,2,2,5,4,1077,0,17,1094,0
200,333,1,179,373,111,0,0,0,1,2,4,1,4,9,1018,0,12,1030,0
201,613,4,54,371,87,0,0,1,1,0,1,1,1,2,1136,0,17,1153,0
202,281,1,31,298,27,1,0,1,0,0,1,2,5,0,648,0,10,658,0
203,274,2,25,180,77,0,0,0,0,2,1,1,0,0,562,0,4,566,0
204,124,1,25,451,25,0,0,0,2,0,0,5,2,2,637,0,9,646,0
205,101,0,17,457,24,0,0,0,0,0,1,4,1,1,606,0,2,608,0
206,519,2,110,201,71,0,2,1,0,0,2,1,4,2,915,0,20,935,0
207,256,3,35,498,49,0,3,0,0,4,1,6,6,1,862,0,5,867,0
208,508,3,126,209,231,1,0,1,0,0,1,1,1,0,1082,0,11,1093,0
209,316,0,77,546,50,0,4,1,1,5,3,12,4,2,1021,0,9,1030,0
210,88,2,8,265,17,0,2,0,0,1,1,2,1,1,388,0,1,389,0
211,334,5,112,361,248,3,0,5,1,3,4,6,5,2,1089,0,6,1095,0
212,459,5,93,393,162,2,1,2,0,3,1,7,4,2,1134,0,8,1142,0
213,318,3,41,515,49,1,1,1,3,2,1,4,9,2,950,0,5,955,0
214,186,2,54,42,68,0,0,1,0,0,0,1,1,0,355,0,0,355,0
215,395,2,104,222,84,0,4,0,1,1,3,4,5,4,829,0,13,842,0
216,506,1,161,56,205,2,2,1,1,0,3,4,3,2,947,0,14,961,0
217,442,1,97,10,116,1,0,0,0,0,1,2,4,2,676,0,13,689,0
218,335,1,123,101,103,2,0,0,0,0,1,0,0,1,667,0,9,676,1
219,522,6,130,204,201,1,2,0,0,1,3,5,4,1,1080,0,8,1088,0
220,229,1,72,311,17,1,1,0,1,1,2,6,3,2,647,0,6,653,0
221,106,0,28,373,9,0,2,1,1,1,0,5,3,0,529,0,5,534,0
222,350,1,73,80,61,0,1,0,1,0,1,0,1,1,570,0,5,575,0
223,368,2,57,131,44,0,0,0,0,0,2,0,3,2,609,0,5,614,0
224,267,7,56,710,102,2,4,2,1,0,2,5,4,1,1163,0,5,1168,0
225,688,2,91,45,192,1,1,2,0,1,1,0,3,0,1027,0,18,1045,0
226,382,0,53,155,279,2,0,1,0,0,1,2,0,2,877,0,5,882,0
227,55,0,6,266,8,1,0,1,0,2,0,3,2,0,344,0,2,346,0
228,205,2,13,371,19,1,0,0,0,0,0,1,3,1,616,0,2,618,0
229,322,2,36,112,28,0,3,1,0,0,1,1,0,1,507,0,8,515,0
230,687,2,47,191,113,1,1,0,1,0,3,0,0,2,1048,0,12,1060,0
231,923,0,20,31,123,1,0,0,0,0,0,0,0,1,1099,0,11,1110,0
232,268,6,13,553,71,0,3,2,0,2,1,8,6,2,935,0,10,945,2
233,514,2,69,305,102,3,4,1,0,0,1,2,4,1,1008,0,6,1014,0
234,388,8,100,145,137,2,2,2,0,2,2,2,5,0,795,0,5,800,0
235,468,2,42,266,93,2,1,2,1,2,4,6,2,3,894,0,9,903,0
236,332,6,15,500,61,0,2,0,0,2,2,1,3,3,927,0,7,934,0
237,210,4,19,833,25,0,1,0,0,2,1,15,6,1,1117,0,15,1132,0
238,332,7,74,521,94,1,1,1,2,3,3,17,7,0,1063,0,9,1072,0
239,595,1,24,22,75,3,0,0,0,0,3,0,1,2,726,0,10,736,0
240,579,2,140,154,140,1,3,1,1,0,0,6,2,1,1030,0,14,1044,0
241,84,1,53,67,101,1,0,0,1,3,1,0,0,1,313,0,3,316,0
242,374,1,136,34,127,1,2,0,0,2,2,2,2,1,684,0,7,691,0
243,519,4,69,68,298,2,3,1,2,0,2,1,3,4,976,0,17,993,0
1,207,4,8,347,9,1,0,0,0,0,0,1,2,0,579,0,3,582,0
2,223,7,11,409,23,4,3,1,1,2,3,8,7,2,704,0,4,708,0
3,290,2,66,615,102,1,6,7,1,3,3,5,8,4,1113,0,12,1125,0
4,272,7,96,549,54,0,3,1,0,4,3,1,3,0,993,0,3,996,0
5,185,4,96,465,57,1,3,1,2,2,0,5,6,1,828,0,9,837,0
6,105,3,30,230,6,0,0,0,0,1,2,1,0,1,379,0,4,383,0
7,348,5,90,457,125,4,3,2,0,5,1,4,11,3,1058,0,11,1069,0
8,239,2,6,300,6,0,0,0,0,2,0,0,2,1,558,0,3,561,0
9,273,1,10,424,2,1,1,1,1,0,1,1,5,2,723,0,6,729,0
10,81,1,54,363,99,3,6,4,0,3,2,2,1,1,620,0,2,622,0
11,210,3,30,287,68,2,1,1,0,4,0,0,2,0,608,0,2,610,0
12,123,2,27,273,219,1,0,2,0,3,3,0,1,0,654,0,1,655,0
13,432,3,183,412,34,3,4,2,1,4,8,10,3,5,1104,0,23,1127,0
14,201,3,22,417,51,0,2,0,0,2,2,3,2,0,705,0,5,710,0
15,291,1,22,198,37,1,1,0,1,2,2,2,2,1,561,0,7,568,0
16,242,7,51,526,81,1,3,2,2,3,6,7,5,3,939,0,16,955,0
17,228,5,36,605,132,2,6,3,3,4,3,8,11,3,1049,0,15,1064,0
18,269,7,188,598,48,2,8,1,5,7,4,9,9,4,1159,0,11,1170,0
19,368,1,31,522,42,0,1,1,0,2,1,1,2,1,973,0,5,978,0
20,195,0,140,155,133,3,0,1,0,0,3,4,3,2,639,0,7,646,0
21,134,3,112,692,75,0,2,2,0,7,2,12,11,4,1056,0,13,1069,0
22,306,1,56,492,39,1,1,1,0,4,2,5,8,2,918,0,12,930,0
23,325,0,39,480,108,1,1,2,0,0,0,6,6,1,969,0,7,976,0
24,186,6,176,581,33,2,2,0,2,7,2,6,9,0,1012,0,13,1025,0
25,76,2,9,481,21,0,2,1,0,1,0,0,1,0,594,0,1,595,0
26,124,2,52,336,95,3,4,4,0,3,6,5,6,1,641,0,4,645,0
27,142,3,34,542,77,2,2,0,0,1,2,2,1,1,809,0,2,811,0
28,47,0,18,419,39,1,1,0,0,2,3,13,7,4,554,0,0,554,0
29,161,2,64,775,57,1,3,1,2,7,2,5,12,3,1095,0,9,1104,1
30,148,2,51,538,47,0,4,0,0,5,2,17,8,4,826,0,6,832,0
31,125,0,32,572,29,1,2,0,0,3,0,7,9,2,782,0,9,791,0
32,320,1,54,497,7,1,1,0,1,0,2,9,4,3,900,0,18,918,0
33,76,3,60,636,26,0,5,2,1,2,5,11,6,3,836,0,4,840,0
34,245,1,99,210,138,1,0,0,0,3,1,5,4,1,708,0,8,716,0
35,222,1,60,345,24,0,2,1,0,2,3,2,0,2,664,0,7,671,0
36,383,0,119,22,76,1,0,0,1,1,0,1,0,0,604,0,3,607,0
37,122,1,46,350,40,0,2,0,0,9,2,3,4,2,581,0,5,586,0
38,385,1,52,27,116,0,0,0,0,0,1,0,0,1,583,0,9,592,0
39,47,1,44,593,71,3,4,2,1,3,4,5,5,2,785,0,12,797,0
40,70,6,58,768,43,0,4,2,1,6,4,6,14,3,985,0,7,992,0
41,74,0,37,493,39,1,0,1,1,2,1,7,0,0,656,0,1,657,0
42,189,6,31,651,37,0,3,0,0,2,4,13,3,2,941,0,11,952,0
43,475,4,40,183,120,0,0,0,0,0,2,6,6,1,837,0,20,857,0
44,227,2,57,474,58,0,2,0,1,0,1,19,9,4,854,0,10,864,0
45,32,1,5,307,21,0,0,0,0,0,0,9,2,2,379,0,6,385,0
46,115,3,48,836,22,2,1,2,0,2,10,20,8,4,1073,0,6,1079,0
47,195,2,39,450,46,1,0,0,0,0,2,3,1,1,740,0,13,753,0
48,212,2,51,442,61,1,0,0,0,0,1,3,1,3,777,0,3,780,0
49,110,0,55,297,45,0,1,0,0,0,0,0,0,0,508,0,0,508,0
50,201,2,80,389,69,2,0,0,0,1,0,3,1,1,749,0,2,751,0
51,128,1,64,497,63,2,1,1,2,1,5,14,3,1,783,0,11,794,0
52,127,1,48,679,82,0,2,0,1,1,2,1,5,1,950,0,7,957,0
53,152,1,65,706,83,1,2,4,1,1,7,11,5,2,1041,0,7,1048,0
54,105,0,72,387,67,0,0,0,0,1,0,2,0,0,634,0,4,638,0
55,115,0,25,475,95,2,1,1,1,0,2,5,0,2,724,0,5,729,0
56,121,4,33,861,53,2,0,0,0,8,1,24,2,1,1110,0,8,1118,0
57,115,1,24,552,89,1,1,0,0,1,5,4,12,5,810,0,5,815,0
58,178,4,60,734,65,4,3,2,3,8,10,19,14,2,1106,0,16,1122,0
59,107,1,28,538,55,3,1,2,1,0,2,9,3,2,752,0,10,762,0
60,96,1,37,585,34,2,1,1,2,4,3,8,3,2,779,0,5,784,0
61,78,1,35,444,19,0,4,1,1,2,5,9,4,0,603,0,7,610,0
62,76,2,42,241,47,0,0,0,1,0,1,4,3,1,418,0,4,422,0
63,156,2,64,679,65,0,0,0,0,0,3,7,1,1,978,0,6,984,0
64,207,3,75,726,66,1,4,2,0,2,8,21,6,4,1125,0,10,1135,0
65,238,4,57,491,47,2,0,0,1,1,3,6,4,1,855,0,10,865,0
66,275,4,25,655,17,2,4,2,0,10,3,13,11,9,1030,0,28,1058,0
67,117,3,23,259,38,0,0,1,0,1,0,5,2,1,450,0,3,453,0
68,73,3,41,218,22,1,0,1,1,2,1,1,1,2,367,0,6,373,0
69,311,0,44,548,123,0,2,0,0,1,5,3,3,2,1042,0,8,1050,0
70,114,2,48,396,30,1,0,0,1,0,2,8,3,4,609,0,1,610,0
71,154,3,56,298,40,1,2,0,0,3,1,2,3,1,564,0,16,580,0
72,170,6,41,684,114,1,1,2,0,3,7,13,2,1,1045,0,10,1055,0
73,166,5,17,722,67,3,3,2,0,2,6,22,13,4,1032,0,15,1047,0
74,156,4,62,744,46,0,3,0,0,1,6,17,4,4,1047,0,9,1056,0
75,172,5,83,701,62,2,2,4,2,0,4,16,10,3,1066,0,11,1077,0
76,121,3,36,587,60,1,2,0,2,1,8,11,1,1,834,0,2,836,0
77,179,0,57,637,66,2,1,0,0,0,0,7,1,2,952,0,7,959,0
78,123,1,86,294,58,0,1,0,0,0,0,2,1,0,566,0,7,573,0
79,144,2,92,467,48,0,1,0,1,0,2,6,1,0,764,0,6,770,0
80,221,1,98,561,62,0,2,1,2,2,0,2,4,0,956,0,7,963,0
81,115,1,93,323,61,0,0,0,0,0,1,2,1,1,598,0,10,608,0
82,146,4,44,541,37,1,0,0,0,1,2,7,4,0,787,0,3,790,0
83,118,3,65,575,35,2,0,0,0,1,0,6,3,0,808,0,6,814,0
84,193,1,128,592,29,2,3,2,0,5,4,8,12,2,981,0,4,985,0
85,192,4,84,752,56,2,3,3,0,4,7,6,7,2,1122,0,3,1125,0
86,150,2,93,744,78,3,2,2,0,4,15,7,14,2,1116,0,17,1133,0
87,285,0,54,276,372,5,1,1,1,4,5,1,2,2,1009,0,7,1016,0
88,144,2,21,385,30,0,1,0,1,1,0,3,3,0,591,0,3,594,0
89,167,1,19,371,25,0,0,3,0,0,0,2,4,2,594,0,6,600,0
90,295,1,14,394,100,4,2,1,2,0,1,4,3,3,824,0,7,831,0
91,209,1,65,621,141,2,3,0,1,2,5,10,3,8,1071,0,12,1083,0
92,351,0,34,551,109,0,3,1,0,2,3,3,0,0,1057,0,13,1070,0
93,184,0,47,333,29,1,0,0,0,2,2,2,3,0,603,0,7,610,0
94,363,4,29,321,75,0,0,0,2,2,1,2,0,1,800,0,6,806,0
95,457,4,32,388,84,0,3,1,0,3,2,3,6,3,986,0,10,996,0
96,177,4,27,298,28,0,1,0,0,0,0,0,2,0,537,0,2,539,0
97,177,4,23,553,26,1,2,3,0,0,3,6,10,1,809,0,12,821,0
98,152,3,39,799,39,5,4,2,2,3,5,6,3,1,1063,0,8,1071,0
99,224,1,88,476,59,0,4,1,0,2,2,6,7,5,875,0,5,880,0
100,186,3,61,788,23,1,3,2,1,3,2,14,12,4,1103,0,9,1112,0
101,133,2,43,517,161,0,2,2,1,0,3,2,5,3,874,0,8,882,0
102,116,0,52,296,130,1,1,0,1,2,5,5,0,4,613,0,7,620,0
103,97,2,66,546,51,2,5,1,1,3,4,4,7,1,790,0,6,796,0
104,335,2,133,145,101,1,1,0,0,0,1,0,1,0,720,0,10,730,0
105,144,2,356,367,145,3,3,2,0,1,3,7,1,1,1035,0,3,1038,0
106,307,3,177,349,152,1,5,0,3,2,3,7,6,3,1018,0,17,1035,0
107,217,0,54,458,124,4,2,1,0,2,1,5,1,1,870,0,5,875,0
108,76,0,73,220,114,0,0,1,0,0,2,3,1,0,490,0,3,493,0
109,130,0,159,227,84,3,1,2,1,1,0,4,3,3,618,0,6,624,0
110,256,3,120,158,83,0,3,0,0,0,0,2,1,1,627,0,4,631,0
111,311,2,83,282,9,1,0,1,0,0,0,2,3,2,696,0,2,698,0
112,75,2,47,625,76,3,2,2,3,3,4,3,5,1,851,0,5,856,0
113,390,4,86,445,72,0,8,1,1,3,2,6,8,3,1029,0,18,1047,0
114,472,5,132,260,172,3,1,1,1,0,1,9,9,2,1068,0,13,1081,0
115,396,2,40,139,104,1,0,0,1,2,0,4,0,1,690,0,4,694,0
116,151,3,17,184,73,0,3,0,0,0,1,2,1,0,435,0,4,439,0
117,273,4,42,638,49,1,1,2,0,2,4,7,1,2,1026,0,4,1030,0
118,250,0,12,424,4,0,1,1,0,1,0,7,5,0,705,0,6,711,0
119,72,0,17,235,11,0,0,0,0,0,0,1,2,0,338,0,3,341,0
120,271,1,73,422,74,0,2,2,1,0,0,1,0,0,847,0,5,852,0
121,220,1,95,390,67,1,2,1,0,2,2,6,2,2,791,0,6,797,0
122,359,1,85,223,91,3,1,0,0,1,2,0,0,1,767,0,8,775,0
123,296,1,61,631,24,3,2,2,1,1,2,7,4,0,1035,0,6,1041,0
124,699,0,118,29,180,0,0,0,0,0,0,1,1,3,1031,0,17,1048,0
125,143,3,10,222,61,0,1,0,0,0,1,2,0,0,443,0,9,452,0
126,320,2,9,541,9,0,1,2,1,2,1,3,4,0,895,0,9,904,0
127,271,7,25,580,154,0,1,1,0,1,0,1,2,0,1043,0,7,1050,0
128,340,2,61,371,109,1,1,0,0,0,2,4,6,2,899,0,15,914,0
129,394,0,16,465,128,2,1,3,0,2,5,4,3,2,1025,0,11,1036,0
130,298,4,82,462,111,4,10,0,2,4,8,7,7,3,1002,0,23,1025,0
131,464,8,32,596,36,1,3,4,0,3,2,5,4,4,1162,0,28,1190,0
132,301,1,82,552,89,2,5,3,1,4,1,6,8,3,1058,0,8,1066,0
133,272,5,27,300,23,0,3,1,0,1,0,3,4,0,639,0,10,649,0
134,247,5,46,485,97,0,4,0,0,3,4,11,6,1,909,0,18,927,0
135,460,2,31,206,199,1,0,0,0,0,5,4,0,1,909,0,6,915,0
136,258,2,35,359,33,1,2,0,1,3,1,2,6,1,704,0,2,706,0
137,232,2,46,245,95,0,0,1,0,0,0,2,1,0,624,0,5,629,0
138,246,5,100,183,69,1,3,0,0,1,1,2,3,2,616,0,9,625,0
139,450,1,32,107,274,4,1,1,1,2,1,0,0,1,875,0,7,882,0
140,288,3,91,516,129,3,0,0,3,0,3,9,13,4,1062,0,21,1083,0
141,166,2,6,295,31,2,0,1,0,1,3,1,1,0,509,0,3,512,0
142,315,2,90,285,98,1,0,0,1,2,1,0,5,5,805,0,9,814,0
143,153,2,7,217,24,1,2,2,0,1,2,3,2,2,418,0,6,424,0
144,267,1,75,521,27,3,8,0,3,4,4,10,7,4,934,0,10,944,0
145,203,7,30,678,36,0,3,3,2,5,5,5,3,2,982,0,15,997,0
146,298,6,219,427,49,0,3,5,2,3,2,6,7,5,1032,0,14,1046,0
147,474,7,24,399,4,0,2,1,0,0,0,0,0,1,912,0,2,914,0
148,195,2,33,130,171,0,0,0,0,0,0,0,2,1,534,0,3,537,0
149,401,1,88,287,179,2,2,0,1,4,3,2,5,0,975,0,18,993,0
150,140,2,25,319,47,0,0,0,0,0,0,4,2,1,540,0,6,546,0
151,72,0,6,387,22,0,1,1,1,2,3,3,1,3,502,0,6,508,0
152,285,0,38,639,39,0,4,1,3,2,4,3,4,3,1025,0,9,1034,0
153,542,1,159,77,182,3,2,0,0,2,1,3,2,0,974,0,13,987,0
154,398,2,39,405,32,0,0,1,0,1,0,4,1,2,885,0,4,889,0
155,380,1,89,63,147,1,0,0,0,0,3,1,1,0,686,0,7,693,0
156,491,2,216,105,98,1,4,0,0,1,2,2,4,3,929,0,16,945,0
157,454,5,291,6,62,1,0,0,0,0,1,0,1,2,823,0,6,829,0
158,351,2,114,6,135,0,2,0,1,0,0,0,3,2,616,0,2,618,0
159,326,1,57,533,26,0,2,1,2,2,5,3,3,1,962,0,9,971,0
160,206,5,47,753,118,6,5,6,2,3,7,10,8,4,1180,0,12,1192,0
161,254,2,22,619,27,4,5,1,1,6,2,8,5,3,959,0,14,973,0
162,135,0,10,353,46,1,3,0,0,1,0,4,2,1,556,0,1,557,0
163,322,1,27,519,54,3,2,1,0,0,1,2,6,2,940,0,4,944,0
164,266,6,156,640,27,0,4,3,2,2,3,13,11,8,1141,0,6,1147,0
165,171,11,404,385,22,0,2,0,1,2,0,4,5,3,1010,0,6,1016,0
166,256,0,56,587,97,1,7,0,0,2,6,12,5,5,1034,0,14,1048,0
167,181,6,14,255,140,1,2,1,0,1,2,3,1,5,612,0,8,620,0
168,290,3,269,105,72,2,12,0,0,1,5,1,1,1,762,0,6,768,0
169,122,1,29,461,36,2,5,0,0,3,1,5,5,4,674,0,4,678,0
170,175,1,75,797,64,4,3,1,2,2,3,5,3,0,1135,0,6,1141,0
171,473,0,62,439,34,1,2,0,0,2,1,6,3,0,1023,0,12,1035,0
172,222,4,9,360,24,0,4,1,0,5,2,3,4,1,639,0,12,651,0
173,119,3,9,349,105,3,1,2,1,0,5,1,2,0,600,0,3,603,0
174,175,5,176,494,21,3,1,0,1,0,0,5,9,6,896,0,7,903,0
175,652,2,182,5,91,0,1,0,1,0,3,0,5,3,945,0,11,956,0
176,294,2,146,4,137,2,0,0,0,0,1,0,0,2,588,0,5,593,0
177,217,3,83,29,144,4,0,1,0,0,0,2,3,4,490,0,9,499,0
178,279,1,219,46,80,2,0,2,0,0,3,2,1,1,636,0,13,649,0
179,172,1,215,118,135,2,3,1,0,1,3,2,2,4,659,0,15,674,0
180,211,2,65,581,39,1,2,1,0,3,3,6,6,4,924,0,10,934,0
181,57,3,185,400,69,3,2,1,1,1,1,10,5,2,740,0,7,747,0
182,568,3,144,27,217,3,2,2,2,1,5,1,5,2,982,0,17,999,0
183,137,1,155,530,20,0,0,3,3,0,0,3,3,1,856,0,10,866,0
184,554,4,275,37,81,2,0,2,1,3,3,3,6,4,975,0,14,989,0
185,394,4,222,10,188,2,2,0,0,1,2,7,2,2,836,0,15,851,0
186,337,1,35,655,86,3,2,5,2,1,7,11,8,5,1158,0,20,1178,0
187,209,1,73,208,34,1,1,0,0,0,1,2,1,0,531,0,3,534,0
188,158,3,72,444,80,1,3,1,1,1,1,5,2,0,772,0,5,777,0
189,149,3,19,251,76,2,1,1,0,0,1,1,2,1,507,0,8,515,0
190,119,8,41,517,184,2,2,3,1,7,5,8,10,5,912,0,12,924,0
191,302,3,157,243,161,2,5,5,0,0,6,1,10,3,898,0,17,915,0
192,98,5,39,781,38,2,13,2,1,3,5,3,12,8,1010,0,11,1021,0
193,168,1,53,513,78,1,13,2,0,1,2,10,9,2,853,0,11,864,0
194,171,1,101,619,162,2,0,0,1,4,1,4,5,2,1073,0,10,1083,0
195,105,1,18,361,42,1,1,1,0,0,2,4,2,1,539,0,7,546,0
196,225,2,21,419,100,1,1,4,0,3,1,4,2,0,783,0,4,787,0
197,330,3,103,231,135,3,6,2,0,2,6,1,3,1,826,0,14,840,0
198,259,8,148,307,284,5,2,3,0,5,3,6,8,2,1040,0,8,1048,0
199,280,4,107,607,116,3,5,2,1,3,0,3,6,4,1141,0,7,1148,0
200,192,5,235,478,113,4,3,3,1,0,1,4,4,4,1047,0,1,1048,0
201,194,6,142,660,30,2,14,1,2,3,2,12,7,1,1076,0,17,1093,0
202,340,5,84,499,56,0,10,0,1,3,3,4,6,4,1015,0,10,1025,0
203,348,5,204,489,42,2,3,5,0,1,2,12,10,5,1128,0,18,1146,0
204,111,2,118,243,5,0,3,0,1,0,2,2,4,0,491,0,11,502,0
205,133,7,60,378,55,5,10,4,1,2,1,2,1,3,662,0,8,670,0
206,167,1,33,240,73,1,0,1,1,0,4,1,2,3,527,0,8,535,0
207,110,3,104,377,15,2,2,1,1,0,5,2,4,2,628,0,6,634,0
208,260,1,57,310,33,1,2,1,1,2,2,0,4,2,676,0,5,681,0
209,253,3,47,243,282,3,1,1,0,0,1,2,2,3,841,0,10,851,0
210,133,4,53,534,81,1,5,1,1,1,2,1,2,0,819,0,4,823,0
211,421,1,262,209,52,0,1,1,0,1,2,5,13,2,970,0,8,978,0
212,237,0,67,506,106,2,5,1,2,4,2,6,5,3,946,0,16,962,0
213,199,1,64,239,53,2,4,1,2,0,2,5,3,2,577,0,5,582,0
214,298,2,78,540,32,1,4,3,0,1,3,6,4,3,975,0,11,986,0
215,250,0,136,392,52,1,3,1,0,5,3,7,8,2,860,0,7,867,0
216,204,2,35,830,61,0,4,3,1,2,4,9,5,4,1164,0,12,1176,0
217,170,0,16,515,18,0,2,1,0,0,2,6,1,4,735,0,6,741,0
218,484,3,35,437,52,2,1,0,3,1,2,2,1,0,1023,0,11,1034,0
219,117,1,23,648,47,3,6,0,4,2,4,14,6,2,877,0,8,885,0
220,133,2,23,776,81,2,5,2,0,3,1,7,8,4,1047,0,5,1052,0
221,294,2,8,427,15,1,4,2,1,0,1,2,3,1,761,0,4,765,0
222,96,0,21,913,38,2,4,5,1,1,3,14,5,1,1104,0,5,1109,0
223,118,2,21,682,44,8,5,2,0,2,2,9,7,1,903,0,11,914,0
224,56,0,7,408,40,1,0,1,0,2,0,8,0,0,523,0,3,526,0
225,185,0,10,458,13,2,2,1,0,2,8,9,2,3,695,0,20,715,0
226,387,0,113,3,37,1,0,0,0,1,0,0,2,0,544,0,7,551,0
227,246,2,19,690,26,4,2,2,0,1,5,10,1,3,1011,0,10,1021,0
228,344,2,62,73,121,2,0,0,1,0,1,1,0,4,611,0,6,617,0
229,198,1,24,515,19,0,4,2,0,2,3,8,5,1,782,0,3,785,0
230,308,1,37,463,68,0,2,1,2,1,3,5,7,1,899,0,5,904,0
231,258,2,38,551,54,1,4,0,1,9,2,16,8,6,950,0,14,964,0
232,222,8,74,389,79,0,28,2,0,2,1,11,5,5,826,0,16,842,0
233,171,4,54,500,59,2,2,2,0,3,4,4,9,3,817,0,15,832,0
234,175,3,13,758,35,2,7,1,0,4,5,6,8,4,1021,0,12,1033,0
235,96,1,22,376,10,0,3,0,0,1,2,1,5,6,523,0,7,530,0
236,430,1,51,504,21,5,6,0,0,0,0,0,4,1,1023,0,4,1027,0
237,219,4,20,408,6,0,13,2,0,2,2,3,3,5,687,0,13,700,0
238,94,2,49,453,29,1,4,1,0,0,0,4,6,5,648,0,3,651,0
239,199,2,112,623,31,2,14,0,0,6,4,9,8,4,1014,0,10,1024,0
240,556,7,242,35,112,1,4,1,1,3,1,3,5,2,973,0,18,991,0
241,111,3,27,303,11,0,20,1,0,2,2,4,2,0,486,0,5,491,0
242,178,7,43,833,86,3,8,5,0,7,6,7,4,4,1191,0,11,1202,0
243,59,3,59,1020,15,0,2,2,1,3,2,14,10,4,1194,0,9,1203,0
244,70,4,78,916,19,5,10,2,5,2,7,16,8,2,1144,0,11,1155,0
245,153,2,17,711,9,1,3,0,4,3,1,10,5,1,920,0,8,928,0
246,225,3,14,756,89,3,19,3,1,4,1,7,8,2,1135,0,16,1151,0
247,59,0,12,470,51,1,4,0,0,1,1,14,5,1,619,0,4,623,0
248,191,4,195,668,49,4,4,2,1,6,1,14,6,2,1147,0,4,1151,0
249,216,2,22,531,12,0,1,1,0,2,0,1,2,2,792,0,5,797,0
250,442,1,88,67,93,3,4,1,1,1,2,2,2,3,710,0,19,729,0
251,459,1,102,206,139,3,19,1,5,1,3,5,5,1,950,0,22,972,0
252,405,1,29,152,201,3,6,2,1,0,5,4,6,1,816,0,12,828,0
253,243,3,22,782,38,0,1,0,0,1,4,17,6,1,1118,0,11,1129,0
254,343,2,29,224,138,2,1,0,1,2,5,6,5,3,761,0,12,773,0
255,287,2,71,662,46,0,2,3,0,1,1,7,8,0,1090,0,9,1099,0
256,248,3,16,434,64,1,2,0,1,2,1,8,4,0,784,0,8,792,0
257,389,3,13,643,56,1,1,2,0,2,2,6,1,2,1121,0,11,1132,0
258,397,3,17,653,37,1,3,3,0,0,3,11,2,5,1135,0,15,1150,0
259,77,1,38,782,60,0,1,3,6,0,0,5,2,2,977,0,8,985,0
260,109,6,85,741,13,1,2,4,3,4,5,22,9,3,1007,0,14,1021,0
261,154,2,24,899,37,0,3,2,7,1,2,13,1,0,1145,0,8,1153,0
262,55,2,58,425,207,7,6,3,0,2,5,3,3,3,779,0,3,782,0
263,501,3,17,22,169,2,1,1,0,0,1,1,1,0,719,0,8,727,0
264,308,2,15,462,90,2,2,1,0,5,4,4,12,1,908,0,12,920,0
265,227,5,72,552,55,0,2,1,1,2,2,13,8,2,942,0,14,956,0
266,522,3,174,118,32,3,2,2,1,0,0,3,4,6,870,0,12,882,0
267,136,6,46,670,73,5,6,5,4,3,4,6,23,6,993,0,13,1006,0
268,167,2,12,441,18,4,1,0,0,2,1,10,2,1,661,0,19,680,0
269,68,3,61,602,15,2,0,0,0,2,3,12,6,3,777,0,5,782,0
270,139,3,44,663,56,3,2,1,0,3,4,5,3,5,931,0,10,941,0
1,374,1,26,511,156,3,2,1,1,0,5,8,1,0,1089,0,16,1105,0
2,114,3,26,779,12,0,3,2,1,0,3,11,5,1,960,0,4,964,0
3,98,1,15,466,45,0,4,1,1,1,4,12,7,0,655,0,11,666,0
4,200,1,21,329,39,3,1,1,2,2,3,3,2,1,608,0,14,622,0
5,102,0,23,983,75,2,2,1,3,6,2,12,3,3,1217,0,10,1227,0
6,169,0,17,718,19,2,1,1,0,0,5,15,5,5,957,0,11,968,0
7,51,2,22,749,162,2,4,0,2,2,7,10,3,1,1017,0,5,1022,0
8,131,2,35,588,14,0,4,3,1,1,3,13,11,4,810,0,12,822,0
9,63,1,19,326,14,0,1,1,0,0,0,9,2,2,438,0,5,443,0
10,139,0,36,756,50,1,1,1,0,0,1,5,2,3,995,0,8,1003,0
11,85,1,25,432,24,0,1,0,1,1,1,7,1,0,579,0,11,590,0
12,69,1,119,729,69,1,2,1,0,0,3,7,5,1,1007,0,3,1010,0
13,254,0,15,683,65,0,3,1,0,1,3,7,2,1,1035,0,13,1048,0
14,461,0,80,246,61,1,1,0,0,5,1,5,2,2,865,0,10,875,0
15,546,3,279,16,155,2,2,1,1,0,3,1,5,4,1018,0,16,1034,0
16,719,6,115,15,160,2,3,0,1,2,4,3,2,1,1033,0,34,1067,0
17,153,1,10,595,31,0,0,1,2,1,3,11,3,1,812,0,11,823,0
18,569,0,47,92,182,3,1,0,1,0,5,3,0,1,904,0,18,922,0
19,217,0,10,343,59,0,0,1,0,1,1,8,4,0,644,0,3,647,0
20,424,1,84,81,94,1,0,0,0,0,2,0,3,0,690,0,9,699,0
21,604,2,34,54,183,3,1,1,0,0,3,1,6,4,896,0,23,919,0
22,383,3,162,220,32,1,6,0,2,3,1,5,8,5,831,0,18,849,0
23,541,3,22,30,,0,0,0,0,0,0,0,0,0,601,0,2,603,0
24,656,1,118,13,128,1,0,1,0,2,2,1,4,0,927,0,19,946,0
25,287,0,10,482,8,1,4,1,1,1,0,6,2,1,804,0,11,815,0
26,494,0,13,1,71,0,0,0,0,0,1,0,0,0,580,0,2,582,0
27,118,1,6,429,10,0,1,0,0,0,0,10,1,1,577,0,3,580,0
28,235,1,160,354,87,0,1,0,3,1,0,7,1,1,851,0,9,860,0
29,240,4,155,88,71,0,5,0,0,3,1,1,6,4,578,0,16,594,0
30,230,3,65,231,136,1,1,0,0,1,3,7,7,1,686,0,13,699,0
31,147,0,35,0,34,0,0,1,0,0,0,0,1,0,218,0,8,226,0
32,346,4,35,5,177,0,0,0,0,1,0,0,1,1,570,0,16,586,0
33,579,4,224,33,33,1,5,0,2,2,2,4,6,6,901,0,16,917,0
34,183,0,13,325,19,0,0,0,1,1,1,3,3,0,549,0,8,557,0
35,358,3,14,371,11,0,0,2,0,2,0,5,5,0,771,0,14,785,0
36,171,1,48,657,23,0,3,0,1,3,1,7,3,1,919,0,1,920,0
37,124,1,17,561,11,1,1,0,0,2,2,15,1,2,738,0,6,744,0
38,398,4,321,13,103,2,3,0,0,1,3,6,11,5,870,0,18,888,0
39,517,2,20,7,94,0,1,0,1,0,1,1,2,0,646,0,20,666,0
40,205,0,37,201,169,2,4,0,0,1,1,1,2,0,623,0,11,634,0
41,236,0,7,11,258,1,2,3,0,0,1,0,0,1,520,0,3,523,0
42,233,1,88,13,173,1,1,1,1,0,3,2,6,2,525,0,4,529,0
43,249,2,106,29,138,1,3,0,0,1,1,1,2,2,535,0,10,545,0
44,163,4,28,831,19,2,5,2,1,7,7,11,1,3,1084,0,14,1098,0
45,359,4,225,216,28,0,5,0,0,2,1,9,13,7,869,0,11,880,0
46,111,4,4,594,4,3,6,2,2,4,1,2,5,0,742,0,3,745,0
47,414,0,136,24,185,3,0,2,0,0,3,0,3,1,771,0,5,776,0
48,421,2,37,32,260,4,2,2,0,0,1,1,2,3,767,0,12,779,0
49,166,3,53,442,32,0,4,0,1,2,0,3,3,0,709,0,3,712,0
50,119,1,26,532,13,2,3,3,1,0,4,9,5,3,721,0,6,727,0
51,333,2,114,123,144,0,3,1,1,2,0,0,4,1,728,0,13,741,0
52,126,1,28,95,85,2,2,1,0,0,1,1,1,0,343,0,3,346,0
53,438,2,72,278,19,0,1,0,0,0,0,3,2,0,815,0,8,823,0
54,494,0,33,216,41,0,0,0,1,0,0,3,0,1,789,0,0,789,0
55,125,0,4,196,172,1,1,2,0,2,0,2,2,0,507,0,5,512,0
56,362,1,80,439,62,0,1,3,2,3,0,4,5,1,963,0,11,974,0
57,155,0,43,506,39,0,0,0,0,0,0,7,4,2,756,0,7,763,0
58,306,1,11,144,33,1,0,1,0,0,3,5,2,1,508,0,12,520,0
59,146,3,26,719,43,0,2,0,0,3,2,5,2,2,953,0,8,961,0
60,82,2,19,430,7,1,2,0,1,4,6,12,2,0,568,0,8,576,0
61,61,0,42,766,102,0,1,0,0,1,8,26,7,0,1014,0,7,1021,0
62,61,2,100,773,103,1,1,0,0,0,2,16,6,1,1066,0,5,1071,0
63,107,2,8,569,24,1,1,0,0,0,1,16,6,3,738,0,6,744,0
64,83,3,116,670,30,1,1,3,2,2,6,24,7,2,950,0,11,961,0
65,244,4,76,493,113,3,1,1,1,2,5,12,5,1,961,0,21,982,0
66,439,3,79,139,187,1,0,4,0,0,0,7,0,2,861,0,12,873,0
67,229,1,66,385,78,2,1,0,1,0,0,11,2,0,776,0,15,791,0
68,124,2,36,610,25,1,4,3,1,1,4,12,3,3,829,0,6,835,0
69,118,0,14,519,16,0,1,0,1,0,3,12,4,0,688,0,6,694,0
70,147,0,24,564,12,0,0,0,0,1,3,17,5,4,111,0,15,792,0
71,160,1,15,731,32,0,2,1,2,5,2,11,3,1,966,0,5,971,0
72,155,0,43,614,19,0,1,0,1,1,0,3,2,0,839,0,5,844,0
73,117,2,38,564,57,0,2,0,1,1,0,6,2,0,790,0,3,793,0
74,136,6,59,757,58,1,1,1,0,0,1,7,5,1,1033,0,9,1042,0
75,139,2,25,566,5,0,0,1,0,2,2,24,3,0,769,0,11,780,0
76,126,4,13,469,3,0,2,1,1,1,2,14,6,4,646,0,13,659,0
77,172,1,16,569,85,1,0,0,1,1,2,13,5,5,871,0,21,892,0
78,31,0,4,225,14,0,1,0,0,0,0,2,1,0,278,0,1,279,0
79,266,6,12,837,24,1,1,0,0,0,3,16,10,2,1178,0,18,1196,0
80,138,0,10,270,9,0,0,0,0,1,0,0,0,0,428,0,3,431,0
81,170,1,53,386,131,0,0,0,         o|,0,1,0,0,1,743,0,3,746,0
82,212,1,33,575,62,1,1,0,1,0,1,10,3,5,905,0,18,923,0
83,90,4,25,631,21,0,6,1,2,5,5,40,12,6,848,0,13,861,0
84,194,1,42,546,62,1,0,1,1,0,1,3,4,0,856,0,7,863,0
85,128,1,46,660,76,1,2,1,2,0,6,14,1,0,938,0,11,949,0
86,60,3,50,761,44,2,0,1,1,3,9,16,6,3,959,0,4,963,0
87,131,2,54,749,102,0,0,1,1,2,5,24,9,4,1084,0,10,1094,0
88,171,1,35,396,103,1,0,0,0,0,0,0,0,1,708,0,4,712,0
89,167,2,49,425,157,0,0,0,0,0,1,0,1,0,802,0,8,810,0
90,248,2,7,494,42,1,0,0,0,1,4,17,6,2,824,0,17,841,0
91,194,6,11,414,42,0,2,1,0,0,3,5,2,3,683,0,8,691,0
92,141,0,61,312,156,0,0,0,0,0,2,3,0,0,675,0,10,685,0
93,116,1,36,241,72,0,0,0,0,0,0,0,1,0,467,0,0,467,0
94,168,1,29,269,26,1,0,1,1,0,1,4,0,2,503,0,9,512,0
95,215,4,43,359,54,1,1,1,5,1,0,0,1,2,687,0,6,693,0
96,267,4,39,662,59,0,0,1,0,0,0,4,0,1,1037,0,7,1044,0
97,138,2,14,231,17,1,1,0,0,2,0,1,0,0,407,0,3,410,0
98,213,1,35,536,72,0,0,0,1,2,1,4,1,0,866,0,7,873,0
99,205,0,34,402,95,1,0,0,1,1,1,3,1,0,744,0,5,749,0
100,132,3,17,590,60,1,1,0,1,5,2,3,3,4,822,0,9,831,0
101,192,3,65,469,98,1,0,0,0,0,1,0,5,1,835,0,11,846,0
102,248,0,61,338,61,0,0,0,1,0,1,0,0,3,713,0,2,715,0
103,189,1,38,243,47,0,0,1,0,0,0,2,0,1,522,0,6,528,0
104,151,3,45,247,33,0,0,0,0,0,0,1,1,5,486,0,3,489,0
105,277,3,38,571,74,3,3,0,0,2,2,5,7,2,987,0,17,1004,0
106,286,2,33,539,89,0,1,0,0,0,1,4,3,1,959,0,14,973,0
107,43,0,38,201,45,0,0,0,0,0,0,1,1,1,330,0,0,330,0
108,84,0,75,462,165,1,0,0,1,0,0,3,0,3,794,0,2,796,0
109,82,1,40,486,56,0,0,2,0,1,5,5,1,2,681,0,5,686,0
110,52,0,20,315,71,2,1,0,0,1,3,4,1,3,473,0,1,474,0
111,103,2,66,397,96,0,0,0,0,1,0,2,0,1,668,0,1,669,0
112,42,1,34,126,41,0,0,1,1,0,0,1,2,1,250,0,2,252,0
113,132,1,67,475,64,0,0,0,1,1,1,1,1,0,744,0,3,747,0
114,290,9,14,576,24,2,2,0,0,2,1,6,3,4,933,0,14,947,0
115,239,5,28,637,25,0,1,0,0,1,2,7,1,3,949,0,17,966,0
116,231,3,22,234,28,0,1,0,0,0,1,1,0,1,522,0,6,528,0
117,418,2,32,469,48,0,0,0,2,0,0,3,0,0,974,0,10,984,0
118,154,3,53,266,43,0,0,1,3,1,1,0,4,0,529,0,5,534,0
119,162,1,29,344,43,1,0,0,0,0,3,2,3,0,588,0,5,593,0
120,137,0,72,367,66,0,0,0,0,1,1,2,2,0,648,0,11,659,0
121,155,2,117,338,124,0,1,0,5,1,0,0,1,2,746,0,9,755,0
122,107,1,35,194,46,1,0,0,1,0,0,0,0,1,386,0,3,389,0
123,183,1,62,275,59,0,0,0,2,0,0,0,0,1,583,0,3,586,0
124,368,5,33,544,34,0,0,1,1,0,1,12,4,3,1006,0,16,1022,0
125,148,3,12,443,21,1,0,0,3,2,2,5,0,0,640,0,11,651,0
126,184,3,36,320,43,1,1,0,0,0,1,3,4,1,597,0,6,603,0
127,244,2,22,336,35,1,0,0,1,0,0,2,0,2,645,0,17,662,0
128,151,1,17,285,30,0,1,0,1,0,1,6,2,1,496,0,8,504,0
129,284,7,58,413,17,0,1,1,1,1,2,6,2,4,797,0,12,809,0
130,282,4,28,339,22,3,0,0,0,0,1,4,3,2,688,0,14,702,0
131,126,0,119,277,47,0,0,0,0,1,0,2,0,1,573,0,5,578,0
132,147,4,197,376,67,0,0,0,0,0,1,0,0,1,793,0,4,797,0
133,205,1,115,430,28,1,1,0,0,1,1,3,2,0,788,0,8,796,0
134,83,3,48,287,24,1,0,0,1,0,2,8,5,0,462,0,5,467,0
135,72,2,44,369,13,0,0,0,0,0,1,1,1,0,503,0,7,510,0
136,288,3,35,289,78,0,0,0,0,0,0,6,3,1,703,0,18,721,0
137,103,3,31,240,34,1,0,0,0,0,0,1,3,1,417,0,8,425,0
138,118,0,60,257,19,0,0,0,1,0,1,1,0,1,458,0,3,461,0
139,108,2,46,299,44,0,0,1,0,0,1,3,1,0,505,0,9,514,0
140,110,1,30,256,46,1,1,2,0,0,0,1,1,0,449,0,3,452,0
141,198,3,40,345,42,0,0,0,0,3,0,2,0,3,636,0,3,639,0
142,208,1,32,336,34,0,2,0,1,1,2,3,2,1,623,0,10,633,0
143,166,3,8,371,21,2,1,0,0,2,4,14,1,2,595,0,11,606,0
144,164,5,44,369,14,0,0,0,0,0,1,6,2,0,605,0,8,613,0
145,154,0,32,387,8,0,0,1,0,0,0,4,3,2,591,0,10,601,0
146,240,0,32,288,12,0,2,0,0,1,0,1,3,1,580,0,11,591,0
147,210,2,46,421,29,0,1,1,0,0,0,7,1,1,719,0,9,728,0
148,193,2,25,439,26,1,1,0,0,1,3,7,3,3,704,0,14,718,0
149,311,9,17,508,6,0,0,1,0,2,8,13,7,8,890,0,34,924,0
150,158,5,70,476,58,0,1,1,0,0,3,8,2,2,784,0,10,794,0
151,307,3,44,507,15,0,1,1,21,2,0,7,4,2,914,0,17,931,0
152,302,1,64,340,43,1,0,1,1,3,0,2,3,1,762,0,9,771,0
153,187,2,42,284,13,0,0,0,1,0,1,1,0,1,532,0,10,542,0
154,154,0,37,234,39,0,0,0,1,1,0,0,0,2,468,0,5,473,0
155,106,1,144,498,109,0,0,0,0,0,1,1,0,3,863,0,5,868,0
156,74,2,83,385,84,1,2,0,2,0,0,2,3,4,642,0,9,651,0
157,127,0,79,580,64,2,0,0,0,0,1,4,2,4,863,0,4,867,0
158,182,4,34,317,28,0,0,0,0,0,2,6,2,1,576,0,10,586,0
159,158,2,23,353,30,0,1,1,0,2,0,3,2,0,575,0,8,583,0
160,159,2,39,330,39,2,0,0,3,0,0,3,0,2,579,0,5,584,0
161,135,1,40,292,20,0,1,0,0,0,1,1,0,0,491,0,6,497,0
162,261,0,42,207,22,0,0,0,0,0,0,1,0,1,534,0,7,541,0
163,267,3,62,320,41,1,0,0,0,0,0,1,0,0,695,0,7,702,0
164,323,0,68,266,52,0,0,0,0,0,1,0,0,0,710,0,4,714,0
165,147,1,25,187,29,0,0,0,0,0,0,0,0,0,389,0,2,391,0
166,499,2,36,352,165,1,4,0,0,1,2,7,10,3,1082,0,16,1098,0
167,173,0,6,612,19,1,5,0,0,3,4,14,6,5,848,0,22,870,0
168,263,1,29,366,59,1,7,1,0,0,2,12,12,3,756,0,26,782,0
169,111,2,22,639,10,0,2,0,2,1,9,5,3,1,807,0,8,815,0
170,201,1,27,701,34,0,2,0,0,1,2,6,4,1,980,0,11,991,0
171,214,1,23,358,18,1,2,0,1,2,1,2,2,1,626,0,11,637,0
172,99,0,10,301,14,0,0,0,0,0,2,6,1,0,433,0,6,439,0
173,172,0,18,553,7,0,0,0,1,0,0,2,5,0,758,0,8,766,0
174,492,6,76,193,105,1,4,0,2,1,4,6,3,4,897,0,35,932,0
175,223,4,37,547,99,0,1,1,0,1,1,5,1,1,921,0,5,926,0
176,120,1,12,388,8,0,0,0,0,1,2,8,3,1,544,0,5,549,0
177,116,2,7,484,7,0,1,2,0,1,2,5,2,2,631,0,11,642,0
178,41,5,17,263,46,2,0,0,1,0,0,3,0,2,380,0,9,389,0
179,145,2,30,902,32,2,2,3,2,3,2,15,1,1,1142,0,12,1154,0
180,72,5,30,474,28,0,2,1,0,0,1,2,1,0,616,0,6,622,0
181,186,2,33,657,63,1,2,1,0,1,2,2,4,0,954,0,18,972,0
182,117,5,88,694,69,1,2,0,0,0,1,2,4,0,983,0,7,990,0
183,113,0,36,557,41,2,1,0,2,0,0,4,2,1,759,0,3,762,0
184,186,4,32,628,27,0,0,1,0,1,1,7,3,2,892,0,24,916,0
185,90,0,31,596,60,1,1,0,0,0,1,3,1,1,785,0,2,787,0
186,222,0,8,397,6,1,2,1,0,1,1,3,2,3,647,0,9,656,0
187,74,2,19,485,15,1,4,1,1,0,12,5,4,4,627,0,4,631,0
188,96,4,31,646,11,0,3,1,1,5,2,11,8,2,821,0,8,829,0
189,90,2,21,932,37,2,3,0,4,2,3,11,5,4,1116,0,7,1123,0
190,64,2,46,231,12,1,3,3,0,1,0,3,4,0,370,0,4,374,0
191,181,3,74,538,23,3,1,3,2,2,1,15,5,2,853,0,16,869,0
192,279,3,147,533,25,0,1,3,0,0,1,1,4,3,1000,0,7,1007,0
193,123,3,55,670,30,1,0,10,1,3,4,5,4,10,919,0,5,924,0
194,92,8,29,508,25,0,0,1,1,0,2,7,0,2,675,0,7,682,0
195,239,1,35,722,61,1,3,0,0,0,2,8,9,2,1083,0,16,1099,0
196,222,0,60,794,70,2,6,1,0,1,5,14,6,3,1184,0,10,1194,0
197,135,5,12,603,18,0,2,3,0,3,3,3,4,1,792,0,4,796,0
198,357,0,27,341,23,1,1,7,0,1,0,3,0,2,763,0,17,780,0
199,288,3,53,682,76,2,3,4,1,1,6,9,6,3,1137,0,9,1146,0
200,81,2,50,473,7,0,4,0,0,2,2,5,6,4,636,0,5,641,0
201,48,0,32,492,13,0,2,2,1,4,0,1,6,2,603,0,4,607,0
202,163,1,60,748,16,1,4,1,1,4,2,6,3,0,1010,0,5,1015,0
203,281,2,27,404,29,1,1,1,0,1,2,2,2,0,753,0,7,760,0
